12:2 12:2 0:1 0:1 0:1 0:1 0:1 0:1 0:1 0:1 0:1 0:1 0:1 0:1 0:1 0:1 0:1 0:1 0:1 0:1 0:1 0:1 0:1 0:1 0:1 0:1 0:1 0:1 0:1 0:1 0:1 0:1 0:1 0:1 0:1 0:1 0:1 0:1 0:1 0:1 0:1 0:1 0:1 0:1 0:1 0:1 0:1 0:1 0:1 0:1 0:1 0:1 0:1 0:1 0:1 0:1 0:1 0:1 0:1 0:1 0:1 0:1 0:1 0:1 0:1 0:1 0:1 0:1 0:1 0:1 0:1 0:1 0:1 0:1 0:1 0:1 0:1 0:1 0:1 0:1
12:2 12:2 0:1 0:1 0:1 0:1 0:1 0:1 0:1 0:1 0:1 0:1 0:1 0:1 0:1 0:1 0:1 0:1 0:1 0:1 0:1 0:1 0:1 0:1 0:1 0:1 0:1 0:1 0:1 0:1 0:1 0:1 0:1 0:1 0:1 0:1 0:1 0:1 0:1 0:1 0:1 0:1 0:1 0:1 0:1 0:1 0:1 0:1 0:1 0:1 0:1 0:1 0:1 0:1 0:1 0:1 0:1 0:1 0:1 0:1 0:1 0:1 0:1 0:1 0:1 0:1 0:1 0:1 0:1 0:1 0:1 0:1 0:1 0:1 0:1 0:1 0:1 0:1 0:1 0:1
12:2 12:2 0:1 0:1 0:1 0:1 0:1 0:1 0:1 0:1 0:1 0:1 0:1 0:1 0:1 0:1 0:1 0:1 0:1 0:1 0:1 0:1 0:1 0:1 0:1 0:1 0:1 0:1 0:1 0:1 0:1 0:1 0:1 0:1 0:1 0:1 0:1 0:1 0:1 0:1 0:1 0:1 0:1 0:1 0:1 0:1 0:1 0:1 0:1 0:1 0:1 0:1 0:1 0:1 0:1 0:1 0:1 0:1 0:1 0:1 0:1 0:1 0:1 0:1 0:1 0:1 0:1 0:1 0:1 0:1 0:1 0:1 0:1 0:1 0:1 0:1 0:1 0:1 0:1 0:1
12:2 12:2 0:1 0:1 0:1 0:1 0:1 0:1 0:1 0:1 0:1 0:1 0:1 0:1 0:1 0:1 0:1 0:1 0:1 0:1 0:1 0:1 0:1 0:1 0:1 0:1 0:1 0:1 0:1 0:1 0:1 0:1 0:1 0:1 0:1 0:1 0:1 0:1 0:1 0:1 0:1 0:1 0:1 0:1 0:1 0:1 0:1 0:1 0:1 0:1 0:1 0:1 0:1 0:1 0:1 0:1 0:1 0:1 0:1 0:1 0:1 0:1 0:1 0:1 0:1 0:1 0:1 0:1 0:1 0:1 0:1 0:1 0:1 0:1 0:1 0:1 0:1 0:1 0:1 0:1
12:2 12:2 0:1 0:1 0:1 0:1 0:1 0:1 0:1 0:1 0:1 0:1 0:1 0:1 0:1 0:1 0:1 0:1 0:1 0:1 0:1 0:1 0:1 0:1 0:1 0:1 0:1 0:1 0:1 0:1 0:1 0:1 0:1 0:1 0:1 0:1 0:1 0:1 0:1 0:1 0:1 0:1 0:1 0:1 0:1 0:1 0:1 0:1 0:1 0:1 0:1 0:1 0:1 0:1 0:1 0:1 0:1 0:1 0:1 0:1 0:1 0:1 0:1 0:1 0:1 0:1 0:1 0:1 0:1 0:1 0:1 0:1 0:1 0:1 0:1 0:1 0:1 0:1 0:1 0:1
12:2 12:2 0:1 0:1 0:1 0:1 0:1 0:1 0:1 0:1 0:1 0:1 0:1 0:1 0:1 0:1 0:1 0:1 0:1 0:1 0:1 0:1 0:1 0:1 0:1 0:1 0:1 0:1 0:1 0:1 0:1 0:1 0:1 0:1 0:1 0:1 0:1 0:1 0:1 0:1 0:1 0:1 0:1 0:1 0:1 0:1 0:1 0:1 0:1 0:1 0:1 0:1 0:1 0:1 0:1 0:1 0:1 0:1 0:1 0:1 0:1 0:1 0:1 0:1 0:1 0:1 0:1 0:1 0:1 0:1 0:1 0:1 0:1 0:1 0:1 0:1 0:1 0:1 0:1 0:1
12:2 12:2 0:1 0:1 0:1 0:1 0:1 0:1 0:1 0:1 0:1 0:1 0:1 0:1 0:1 0:1 0:1 0:1 0:1 0:1 0:1 0:1 0:1 0:1 0:1 0:1 0:1 0:1 0:1 0:1 0:1 0:1 0:1 0:1 0:1 0:1 0:1 0:1 0:1 0:1 0:1 0:1 0:1 0:1 0:1 0:1 0:1 0:1 0:1 0:1 0:1 0:1 0:1 0:1 0:1 0:1 0:1 0:1 0:1 0:1 0:1 0:1 0:1 0:1 0:1 0:1 0:1 0:1 0:1 0:1 0:1 0:1 0:1 0:1 0:1 0:1 0:1 0:1 0:1 0:1
12:2 12:2 0:1 0:1 0:1 0:1 0:1 0:1 0:1 0:1 0:1 0:1 0:1 0:1 0:1 0:1 0:1 0:1 0:1 0:1 0:1 0:1 0:1 0:1 0:1 0:1 0:1 0:1 0:1 0:1 0:1 0:1 0:1 0:1 0:1 0:1 0:1 0:1 0:1 0:1 0:1 0:1 0:1 0:1 0:1 0:1 0:1 0:1 0:1 0:1 0:1 0:1 0:1 0:1 0:1 0:1 0:1 0:1 0:1 0:1 0:1 0:1 0:1 0:1 0:1 0:1 0:1 0:1 0:1 0:1 0:1 0:1 0:1 0:1 0:1 0:1 0:1 0:1 0:1 0:1
12:2 12:2 0:1 0:1 0:1 0:1 0:1 0:1 0:1 0:1 0:1 0:1 0:1 0:1 0:1 0:1 0:1 0:1 0:1 0:1 0:1 0:1 0:1 0:1 0:1 0:1 0:1 0:1 0:1 0:1 0:1 0:1 0:1 0:1 0:1 0:1 0:1 0:1 0:1 0:1 0:1 0:1 0:1 0:1 0:1 0:1 0:1 0:1 0:1 0:1 0:1 0:1 0:1 0:1 0:1 0:1 0:1 0:1 0:1 0:1 0:1 0:1 0:1 0:1 0:1 0:1 0:1 0:1 0:1 0:1 0:1 0:1 0:1 0:1 0:1 0:1 0:1 0:1 0:1 0:1
12:2 12:2 0:1 0:1 0:1 0:1 0:1 0:1 0:1 0:1 0:1 0:1 0:1 0:1 0:1 0:1 0:1 0:1 0:1 0:1 0:1 0:1 0:1 0:1 0:1 0:1 0:1 0:1 0:1 0:1 0:1 0:1 0:1 0:1 0:1 0:1 0:1 0:1 0:1 0:1 0:1 0:1 0:1 0:1 0:1 0:1 0:1 0:1 0:1 0:1 0:1 0:1 0:1 0:1 0:1 0:1 0:1 0:1 0:1 0:1 0:1 0:1 0:1 0:1 0:1 0:1 0:1 0:1 0:1 0:1 0:1 0:1 0:1 0:1 0:1 0:1 0:1 0:1 0:1 0:1
12:2 12:2 0:1 0:1 0:1 0:1 0:1 0:1 0:1 0:1 0:1 0:1 0:1 0:1 0:1 0:1 0:1 0:1 0:1 0:1 0:1 0:1 0:1 0:1 0:1 0:1 0:1 0:1 0:1 0:1 0:1 0:1 0:1 0:1 0:1 0:1 0:1 0:1 0:1 0:1 0:1 0:1 0:1 0:1 0:1 0:1 0:1 0:1 0:1 0:1 0:1 0:1 0:1 0:1 0:1 0:1 0:1 0:1 0:1 0:1 0:1 0:1 0:1 0:1 0:1 0:1 0:1 0:1 0:1 0:1 0:1 0:1 0:1 0:1 0:1 0:1 0:1 0:1 0:1 0:1
12:2 12:2 0:1 0:1 0:1 0:1 0:1 0:1 0:1 0:1 0:1 0:1 0:1 0:1 0:1 0:1 0:1 0:1 0:1 0:1 0:1 0:1 0:1 0:1 0:1 0:1 0:1 0:1 0:1 0:1 0:1 0:1 0:1 0:1 0:1 0:1 0:1 0:1 0:1 0:1 0:1 0:1 0:1 0:1 0:1 0:1 0:1 0:1 0:1 0:1 0:1 0:1 0:1 0:1 0:1 0:1 0:1 0:1 0:1 0:1 0:1 0:1 0:1 0:1 0:1 0:1 0:1 0:1 0:1 0:1 0:1 0:1 0:1 0:1 0:1 0:1 0:1 0:1 0:1 0:1
12:2 12:2 0:1 0:1 0:1 0:1 0:1 0:1 0:1 0:1 0:1 0:1 0:1 0:1 0:1 0:1 0:1 0:1 0:1 0:1 0:1 0:1 0:1 0:1 0:1 0:1 0:1 0:1 0:1 0:1 0:1 0:1 0:1 0:1 0:1 0:1 0:1 0:1 0:1 0:1 0:1 0:1 0:1 0:1 0:1 0:1 0:1 0:1 0:1 0:1 0:1 0:1 0:1 0:1 0:1 0:1 0:1 0:1 0:1 0:1 0:1 0:1 0:1 0:1 0:1 0:1 0:1 0:1 0:1 0:1 0:1 0:1 0:1 0:1 0:1 0:1 0:1 0:1 0:1 0:1
12:2 12:2 0:1 0:1 0:1 0:1 0:1 0:1 0:1 0:1 0:1 0:1 0:1 0:1 0:1 0:1 0:1 0:1 0:1 0:1 0:1 0:1 0:1 0:1 0:1 0:1 0:1 0:1 0:1 0:1 0:1 0:1 0:1 0:1 0:1 0:1 0:1 0:1 0:1 0:1 0:1 0:1 0:1 0:1 0:1 0:1 0:1 0:1 0:1 0:1 0:1 0:1 0:1 0:1 0:1 0:1 0:1 0:1 0:1 0:1 0:1 0:1 0:1 0:1 0:1 0:1 0:1 0:1 0:1 0:1 0:1 0:1 0:1 0:1 0:1 0:1 0:1 0:1 0:1 0:1
12:2 12:2 0:1 0:1 0:1 0:1 0:1 0:1 0:1 0:1 0:1 0:1 0:1 0:1 0:1 0:1 0:1 0:1 0:1 0:1 0:1 0:1 0:1 0:1 0:1 0:1 0:1 0:1 0:1 0:1 0:1 0:1 0:1 0:1 0:1 0:1 0:1 0:1 0:1 0:1 0:1 0:1 0:1 0:1 0:1 0:1 0:1 0:1 0:1 0:1 0:1 0:1 0:1 0:1 0:1 0:1 0:1 0:1 0:1 0:1 0:1 0:1 0:1 0:1 0:1 0:1 0:1 0:1 0:1 0:1 0:1 0:1 0:1 0:1 0:1 0:1 0:1 0:1 0:1 0:1
12:2 12:2 0:1 0:1 0:1 0:1 0:1 0:1 0:1 0:1 0:1 0:1 0:1 0:1 0:1 0:1 0:1 0:1 0:1 0:1 0:1 0:1 0:1 0:1 0:1 0:1 0:1 0:1 0:1 0:1 0:1 0:1 0:1 0:1 0:1 0:1 0:1 0:1 0:1 0:1 0:1 0:1 0:1 0:1 0:1 0:1 0:1 0:1 0:1 0:1 0:1 0:1 0:1 0:1 0:1 0:1 0:1 0:1 0:1 0:1 0:1 0:1 0:1 0:1 0:1 0:1 0:1 0:1 0:1 0:1 0:1 0:1 0:1 0:1 0:1 0:1 0:1 0:1 0:1 0:1
12:2 12:2 0:1 0:1 0:1 0:1 0:1 0:1 0:1 0:1 0:1 0:1 0:1 0:1 0:1 0:1 0:1 0:1 0:1 0:1 0:1 0:1 0:1 0:1 0:1 0:1 0:1 0:1 0:1 0:1 0:1 0:1 0:1 0:1 0:1 0:1 0:1 0:1 0:1 0:1 0:1 0:1 0:1 0:1 0:1 0:1 0:1 0:1 0:1 0:1 0:1 0:1 0:1 0:1 0:1 0:1 0:1 0:1 0:1 0:1 0:1 0:1 0:1 0:1 0:1 0:1 0:1 0:1 0:1 0:1 0:1 0:1 0:1 0:1 0:1 0:1 0:1 0:1 0:1 0:1
12:2 12:2 0:1 0:1 0:1 0:1 0:1 0:1 0:1 0:1 0:1 0:1 0:1 0:1 0:1 0:1 0:1 0:1 0:1 0:1 0:1 0:1 0:1 0:1 0:1 0:1 0:1 0:1 0:1 0:1 0:1 0:1 0:1 0:1 0:1 0:1 0:1 0:1 0:1 0:1 0:1 0:1 0:1 0:1 0:1 0:1 0:1 0:1 0:1 0:1 0:1 0:1 0:1 0:1 0:1 0:1 0:1 0:1 0:1 0:1 0:1 0:1 0:1 0:1 0:1 0:1 0:1 0:1 0:1 0:1 0:1 0:1 0:1 0:1 0:1 0:1 0:1 0:1 0:1 0:1
12:2 12:2 0:1 0:1 0:1 0:1 0:1 0:1 0:1 0:1 0:1 0:1 0:1 0:1 0:1 0:1 0:1 0:1 0:1 0:1 0:1 0:1 0:1 0:1 0:1 0:1 0:1 0:1 0:1 0:1 0:1 0:1 0:1 0:1 0:1 0:1 0:1 0:1 0:1 0:1 0:1 0:1 0:1 0:1 0:1 0:1 0:1 0:1 0:1 0:1 0:1 0:1 0:1 0:1 0:1 0:1 0:1 0:1 0:1 0:1 0:1 0:1 0:1 0:1 0:1 0:1 0:1 0:1 0:1 0:1 0:1 0:1 0:1 0:1 0:1 0:1 0:1 0:1 0:1 0:1
12:2 12:2 0:1 0:1 0:1 0:1 0:1 0:1 0:1 0:1 0:1 0:1 0:1 0:1 0:1 0:1 0:1 0:1 0:1 0:1 0:1 0:1 0:1 0:1 0:1 0:1 0:1 0:1 0:1 0:1 0:1 0:1 0:1 0:1 0:1 0:1 0:1 0:1 0:1 0:1 0:1 0:1 0:1 0:1 0:1 0:1 0:1 0:1 0:1 0:1 0:1 0:1 0:1 0:1 0:1 0:1 0:1 0:1 0:1 0:1 0:1 0:1 0:1 0:1 0:1 0:1 0:1 0:1 0:1 0:1 0:1 0:1 0:1 0:1 0:1 0:1 0:1 0:1 0:1 0:1
12:2 12:2 0:1 0:1 0:1 0:1 0:1 0:1 0:1 0:1 0:1 0:1 0:1 0:1 0:1 0:1 0:1 0:1 0:1 0:1 0:1 0:1 0:1 0:1 0:1 0:1 0:1 0:1 0:1 0:1 0:1 0:1 0:1 0:1 0:1 0:1 0:1 0:1 0:1 0:1 0:1 0:1 0:1 0:1 0:1 0:1 0:1 0:1 0:1 0:1 0:1 0:1 0:1 0:1 0:1 0:1 0:1 0:1 0:1 0:1 0:1 0:1 0:1 0:1 0:1 0:1 0:1 0:1 0:1 0:1 0:1 0:1 0:1 0:1 0:1 0:1 0:1 0:1 0:1 0:1
12:2 12:2 0:1 0:1 0:1 0:1 0:1 0:1 0:1 0:1 0:1 0:1 0:1 0:1 0:1 0:1 0:1 0:1 0:1 0:1 0:1 0:1 0:1 0:1 0:1 0:1 0:1 0:1 0:1 0:1 0:1 0:1 0:1 0:1 0:1 0:1 0:1 0:1 0:1 0:1 0:1 0:1 0:1 0:1 0:1 0:1 0:1 0:1 0:1 0:1 0:1 0:1 0:1 0:1 0:1 0:1 0:1 0:1 0:1 0:1 0:1 0:1 0:1 0:1 0:1 0:1 0:1 0:1 0:1 0:1 0:1 0:1 0:1 0:1 0:1 0:1 0:1 0:1 0:1 0:1
12:2 12:2 0:1 0:1 0:1 0:1 0:1 0:1 0:1 0:1 0:1 0:1 0:1 0:1 0:1 0:1 0:1 0:1 0:1 0:1 0:1 0:1 0:1 0:1 0:1 0:1 0:1 0:1 0:1 0:1 0:1 0:1 0:1 0:1 0:1 0:1 0:1 0:1 0:1 0:1 0:1 0:1 0:1 0:1 0:1 0:1 0:1 0:1 0:1 0:1 0:1 0:1 0:1 0:1 0:1 0:1 0:1 0:1 0:1 0:1 0:1 0:1 0:1 0:1 0:1 0:1 0:1 0:1 0:1 0:1 0:1 0:1 0:1 0:1 0:1 0:1 0:1 0:1 0:1 0:1
12:2 12:2 0:1 0:1 0:1 0:1 0:1 0:1 0:1 0:1 0:1 0:1 0:1 0:1 0:1 0:1 0:1 0:1 0:1 0:1 0:1 0:1 0:1 0:1 0:1 0:1 0:1 0:1 0:1 0:1 0:1 0:1 0:1 0:1 0:1 0:1 0:1 0:1 0:1 0:1 0:1 0:1 0:1 0:1 0:1 0:1 0:1 0:1 0:1 0:1 0:1 0:1 0:1 0:1 0:1 0:1 0:1 0:1 0:1 0:1 0:1 0:1 0:1 0:1 0:1 0:1 0:1 0:1 0:1 0:1 0:1 0:1 0:1 0:1 0:1 0:1 0:1 0:1 0:1 0:1
12:2 12:2 0:1 0:1 0:1 0:1 0:1 0:1 0:1 0:1 0:1 0:1 0:1 0:1 0:1 0:1 0:1 0:1 0:1 0:1 0:1 0:1 0:1 0:1 0:1 0:1 0:1 0:1 0:1 0:1 0:1 0:1 0:1 0:1 0:1 0:1 0:1 0:1 0:1 0:1 0:1 0:1 0:1 0:1 0:1 0:1 0:1 0:1 0:1 0:1 0:1 0:1 0:1 0:1 0:1 0:1 0:1 0:1 0:1 0:1 0:1 0:1 0:1 0:1 0:1 0:1 0:1 0:1 0:1 0:1 0:1 0:1 0:1 0:1 0:1 0:1 0:1 0:1 0:1 0:1
12:2 12:2 0:1 0:1 0:1 0:1 0:1 0:1 0:1 0:1 0:1 0:1 0:1 0:1 0:1 0:1 0:1 0:1 0:1 0:1 0:1 0:1 0:1 0:1 0:1 0:1 0:1 0:1 0:1 0:1 0:1 0:1 0:1 0:1 0:1 0:1 0:1 0:1 0:1 0:1 0:1 0:1 0:1 0:1 0:1 0:1 0:1 0:1 0:1 0:1 0:1 0:1 0:1 0:1 0:1 0:1 0:1 0:1 0:1 0:1 0:1 0:1 0:1 0:1 0:1 0:1 0:1 0:1 0:1 0:1 0:1 0:1 0:1 0:1 0:1 0:1 0:1 0:1 0:1 0:1
12:2 12:2 0:1 0:1 0:1 0:1 0:1 0:1 0:1 0:1 0:1 0:1 0:1 0:1 0:1 0:1 0:1 0:1 0:1 0:1 0:1 0:1 0:1 0:1 0:1 0:1 0:1 0:1 0:1 0:1 0:1 0:1 0:1 0:1 0:1 0:1 0:1 0:1 0:1 0:1 0:1 0:1 0:1 0:1 0:1 0:1 0:1 0:1 0:1 0:1 0:1 0:1 0:1 0:1 0:1 0:1 0:1 0:1 0:1 0:1 0:1 0:1 0:1 0:1 0:1 0:1 0:1 0:1 0:1 0:1 0:1 0:1 0:1 0:1 0:1 0:1 0:1 0:1 0:1 0:1
12:2 12:2 0:1 0:1 0:1 0:1 0:1 0:1 0:1 0:1 0:1 0:1 0:1 0:1 0:1 0:1 0:1 0:1 0:1 0:1 0:1 0:1 0:1 0:1 0:1 0:1 0:1 0:1 0:1 0:1 0:1 0:1 0:1 0:1 0:1 0:1 0:1 0:1 0:1 0:1 0:1 0:1 0:1 0:1 0:1 0:1 0:1 0:1 0:1 0:1 0:1 0:1 0:1 0:1 0:1 0:1 0:1 0:1 0:1 0:1 0:1 0:1 0:1 0:1 0:1 0:1 0:1 0:1 0:1 0:1 0:1 0:1 0:1 0:1 0:1 0:1 0:1 0:1 0:1 0:1
12:2 12:2 0:1 0:1 0:1 0:1 0:1 0:1 0:1 0:1 0:1 0:1 0:1 0:1 0:1 0:1 0:1 0:1 0:1 0:1 0:1 0:1 0:1 0:1 0:1 0:1 0:1 0:1 0:1 0:1 0:1 0:1 0:1 0:1 0:1 0:1 0:1 0:1 0:1 0:1 0:1 0:1 0:1 0:1 0:1 0:1 0:1 0:1 0:1 0:1 0:1 0:1 0:1 0:1 0:1 0:1 0:1 0:1 0:1 0:1 0:1 0:1 0:1 0:1 0:1 0:1 0:1 0:1 0:1 0:1 0:1 0:1 0:1 0:1 0:1 0:1 0:1 0:1 0:1 0:1
12:2 12:2 0:1 0:1 0:1 0:1 0:1 0:1 0:1 0:1 0:1 0:1 0:1 0:1 0:1 0:1 0:1 0:1 0:1 0:1 0:1 0:1 0:1 0:1 0:1 0:1 0:1 0:1 0:1 0:1 0:1 0:1 0:1 0:1 0:1 0:1 0:1 0:1 0:1 0:1 0:1 0:1 0:1 0:1 0:1 0:1 0:1 0:1 0:1 0:1 0:1 0:1 0:1 0:1 0:1 0:1 0:1 0:1 0:1 0:1 0:1 0:1 0:1 0:1 0:1 0:1 0:1 0:1 0:1 0:1 0:1 0:1 0:1 0:1 0:1 0:1 0:1 0:1 0:1 0:1
12:2 12:2 0:1 0:1 0:1 0:1 0:1 0:1 0:1 0:1 0:1 0:1 12:2 12:2 12:2 12:2 12:2 12:2 12:2 12:2 12:2 12:2 12:2 12:2 12:2 12:2 12:2 12:2 12:2 12:2 12:2 12:2 12:2 12:2 12:2 12:2 12:2 12:2 12:2 12:2 12:2 12:2 12:2 12:2 12:2 12:2 12:2 12:2 12:2 12:2 12:2 12:2 12:2 12:2 12:2 12:2 12:2 12:2 12:2 12:2 12:2 12:2 12:2 12:2 12:2 12:2 12:2 12:2 12:2 12:2 12:2 12:2 12:2 12:2 12:2 12:2 12:2 12:2 12:2 12:2
12:2 12:2 0:1 0:1 0:1 0:1 0:1 0:1 0:1 0:1 0:1 0:1 12:2 12:2 12:2 12:2 12:2 12:2 12:2 12:2 12:2 12:2 12:2 12:2 12:2 12:2 12:2 12:2 12:2 12:2 12:2 12:2 12:2 12:2 12:2 12:2 12:2 12:2 12:2 12:2 12:2 12:2 12:2 12:2 12:2 12:2 12:2 12:2 12:2 12:2 12:2 12:2 12:2 12:2 12:2 12:2 12:2 12:2 12:2 12:2 12:2 12:2 12:2 12:2 12:2 12:2 12:2 12:2 12:2 12:2 12:2 12:2 12:2 12:2 12:2 12:2 12:2 12:2 12:2 12:2
12:2 12:2 0:1 0:1 0:1 0:1 0:1 0:1 0:1 0:1 0:1 0:1 12:2 12:2 12:2 12:2 12:2 12:2 12:2 12:2 12:2 12:2 12:2 12:2 12:2 12:2 12:2 12:2 12:2 12:2 12:2 12:2 12:2 12:2 12:2 12:2 12:2 12:2 12:2 12:2 12:2 12:2 12:2 12:2 12:2 12:2 12:2 12:2 12:2 12:2 12:2 12:2 12:2 12:2 12:2 12:2 12:2 12:2 12:2 12:2 12:2 12:2 12:2 12:2 12:2 12:2 12:2 12:2 12:2 12:2 12:2 12:2 12:2 12:2 12:2 12:2 12:2 12:2 12:2 12:2
12:2 12:2 0:1 0:1 0:1 0:1 0:1 0:1 0:1 0:1 0:1 0:1 12:2 12:2 12:2 12:2 12:2 12:2 12:2 12:2 12:2 12:2 12:2 12:2 12:2 12:2 12:2 12:2 12:2 12:2 12:2 12:2 12:2 12:2 12:2 12:2 12:2 12:2 12:2 12:2 12:2 12:2 12:2 12:2 12:2 12:2 12:2 12:2 12:2 12:2 12:2 12:2 12:2 12:2 12:2 12:2 12:2 12:2 12:2 12:2 12:2 12:2 12:2 12:2 12:2 12:2 12:2 12:2 12:2 12:2 12:2 12:2 12:2 12:2 12:2 12:2 12:2 12:2 12:2 12:2
12:2 12:2 0:1 0:1 0:1 0:1 0:1 0:1 0:1 0:1 0:1 0:1 12:2 12:2 12:2 12:2 12:2 12:2 12:2 12:2 12:2 12:2 12:2 12:2 12:2 12:2 12:2 12:2 12:2 12:2 12:2 12:2 12:2 12:2 12:2 12:2 12:2 12:2 12:2 12:2 12:2 12:2 12:2 12:2 12:2 12:2 12:2 12:2 12:2 12:2 12:2 12:2 12:2 12:2 12:2 12:2 12:2 12:2 12:2 12:2 12:2 12:2 12:2 12:2 12:2 12:2 12:2 12:2 12:2 12:2 12:2 12:2 12:2 12:2 12:2 12:2 12:2 12:2 12:2 12:2
12:2 12:2 0:1 0:1 0:1 0:1 0:1 0:1 0:1 0:1 0:1 0:1 12:2 12:2 12:2 12:2 12:2 12:2 12:2 12:2 12:2 12:2 12:2 12:2 12:2 12:2 12:2 12:2 12:2 12:2 12:2 12:2 12:2 12:2 12:2 12:2 12:2 12:2 12:2 12:2 12:2 12:2 12:2 12:2 12:2 12:2 12:2 12:2 12:2 12:2 12:2 12:2 12:2 12:2 12:2 12:2 12:2 12:2 12:2 12:2 12:2 12:2 12:2 12:2 12:2 12:2 12:2 12:2 12:2 12:2 12:2 12:2 12:2 12:2 12:2 12:2 12:2 12:2 12:2 12:2
12:2 12:2 0:1 0:1 0:1 0:1 0:1 0:1 0:1 0:1 0:1 0:1 12:2 12:2 12:2 12:2 12:2 12:2 12:2 12:2 12:2 12:2 12:2 12:2 12:2 12:2 12:2 12:2 12:2 12:2 12:2 12:2 12:2 12:2 12:2 12:2 12:2 12:2 12:2 12:2 12:2 12:2 12:2 12:2 12:2 12:2 12:2 12:2 12:2 12:2 12:2 12:2 12:2 12:2 12:2 12:2 12:2 12:2 12:2 12:2 12:2 12:2 12:2 12:2 12:2 12:2 12:2 12:2 12:2 12:2 12:2 12:2 12:2 12:2 12:2 12:2 12:2 12:2 12:2 12:2
12:2 12:2 0:1 0:1 0:1 0:1 0:1 0:1 0:1 0:1 0:1 0:1 12:2 12:2 12:2 12:2 12:2 12:2 12:2 12:2 12:2 12:2 12:2 12:2 12:2 12:2 12:2 12:2 12:2 12:2 12:2 12:2 12:2 12:2 12:2 12:2 12:2 12:2 12:2 12:2 12:2 12:2 12:2 12:2 12:2 12:2 12:2 12:2 12:2 12:2 12:2 12:2 12:2 12:2 12:2 12:2 12:2 12:2 12:2 12:2 12:2 12:2 12:2 12:2 12:2 12:2 12:2 12:2 12:2 12:2 12:2 12:2 12:2 12:2 12:2 12:2 12:2 12:2 12:2 12:2
12:2 12:2 0:1 0:1 0:1 0:1 0:1 0:1 0:1 0:1 0:1 0:1 12:2 12:2 12:2 12:2 12:2 12:2 12:2 12:2 12:2 12:2 12:2 12:2 12:2 12:2 12:2 12:2 12:2 12:2 12:2 12:2 12:2 12:2 12:2 12:2 12:2 12:2 12:2 12:2 12:2 12:2 12:2 12:2 12:2 12:2 12:2 12:2 12:2 12:2 12:2 12:2 12:2 12:2 12:2 12:2 12:2 12:2 12:2 12:2 12:2 12:2 12:2 12:2 12:2 12:2 12:2 12:2 12:2 12:2 12:2 12:2 12:2 12:2 12:2 12:2 12:2 12:2 12:2 12:2
12:2 12:2 0:1 0:1 0:1 0:1 0:1 0:1 0:1 0:1 0:1 0:1 12:2 12:2 12:2 12:2 12:2 12:2 12:2 12:2 12:2 12:2 12:2 12:2 12:2 12:2 12:2 12:2 12:2 12:2 12:2 12:2 12:2 12:2 12:2 12:2 12:2 12:2 12:2 12:2 12:2 12:2 12:2 12:2 12:2 12:2 12:2 12:2 12:2 12:2 12:2 12:2 12:2 12:2 12:2 12:2 12:2 12:2 12:2 12:2 12:2 12:2 12:2 12:2 12:2 12:2 12:2 12:2 12:2 12:2 12:2 12:2 12:2 12:2 12:2 12:2 12:2 12:2 12:2 12:2
12:2 12:2 0:1 0:1 0:1 0:1 0:1 0:1 0:1 0:1 0:1 0:1 12:2 12:2 12:2 12:2 12:2 12:2 12:2 12:2 12:2 12:2 12:2 12:2 12:2 12:2 12:2 12:2 12:2 12:2 12:2 12:2 12:2 12:2 12:2 12:2 12:2 12:2 12:2 12:2 12:2 12:2 12:2 12:2 12:2 12:2 12:2 12:2 12:2 12:2 12:2 12:2 12:2 12:2 12:2 12:2 12:2 12:2 12:2 12:2 12:2 12:2 12:2 12:2 12:2 12:2 12:2 12:2 12:2 12:2 12:2 12:2 12:2 12:2 12:2 12:2 12:2 12:2 12:2 12:2
12:2 12:2 0:1 0:1 0:1 0:1 0:1 0:1 0:1 0:1 0:1 0:1 12:2 12:2 12:2 12:2 12:2 12:2 12:2 12:2 12:2 12:2 12:2 12:2 12:2 12:2 12:2 12:2 12:2 12:2 12:2 12:2 12:2 12:2 12:2 12:2 12:2 12:2 12:2 12:2 12:2 12:2 12:2 12:2 12:2 12:2 12:2 12:2 12:2 12:2 12:2 12:2 12:2 12:2 12:2 12:2 12:2 12:2 12:2 12:2 12:2 12:2 12:2 12:2 12:2 12:2 12:2 12:2 12:2 12:2 12:2 12:2 12:2 12:2 12:2 12:2 12:2 12:2 12:2 12:2
12:2 12:2 0:1 0:1 0:1 0:1 0:1 0:1 0:1 0:1 0:1 0:1 12:2 12:2 12:2 12:2 12:2 12:2 12:2 12:2 12:2 12:2 12:2 12:2 12:2 12:2 12:2 12:2 12:2 12:2 12:2 12:2 12:2 12:2 12:2 12:2 12:2 12:2 12:2 12:2 12:2 12:2 12:2 12:2 12:2 12:2 12:2 12:2 12:2 12:2 12:2 12:2 12:2 12:2 12:2 12:2 12:2 12:2 12:2 12:2 12:2 12:2 12:2 12:2 12:2 12:2 12:2 12:2 12:2 12:2 12:2 12:2 12:2 12:2 12:2 12:2 12:2 12:2 12:2 12:2
12:2 12:2 0:1 0:1 0:1 0:1 0:1 0:1 0:1 0:1 0:1 0:1 12:2 12:2 12:2 12:2 12:2 12:2 12:2 12:2 12:2 12:2 12:2 12:2 12:2 12:2 12:2 12:2 12:2 12:2 12:2 12:2 12:2 12:2 12:2 12:2 12:2 12:2 12:2 12:2 12:2 12:2 12:2 12:2 12:2 12:2 12:2 12:2 12:2 12:2 12:2 12:2 12:2 12:2 12:2 12:2 12:2 12:2 12:2 12:2 12:2 12:2 12:2 12:2 12:2 12:2 12:2 12:2 12:2 12:2 12:2 12:2 12:2 12:2 12:2 12:2 12:2 12:2 12:2 12:2
12:2 12:2 0:1 0:1 0:1 0:1 0:1 0:1 0:1 0:1 0:1 0:1 12:2 12:2 12:2 12:2 12:2 12:2 12:2 12:2 12:2 12:2 12:2 12:2 12:2 12:2 12:2 12:2 12:2 12:2 12:2 12:2 12:2 12:2 12:2 12:2 12:2 12:2 12:2 12:2 12:2 12:2 12:2 12:2 12:2 12:2 12:2 12:2 12:2 12:2 12:2 12:2 12:2 12:2 12:2 12:2 12:2 12:2 12:2 12:2 12:2 12:2 12:2 12:2 12:2 12:2 12:2 12:2 12:2 12:2 12:2 12:2 12:2 12:2 12:2 12:2 12:2 12:2 12:2 12:2
12:2 12:2 0:1 0:1 0:1 0:1 0:1 0:1 0:1 0:1 0:1 0:1 12:2 12:2 12:2 12:2 12:2 12:2 12:2 12:2 12:2 12:2 12:2 12:2 12:2 12:2 12:2 12:2 12:2 12:2 12:2 12:2 12:2 12:2 12:2 12:2 12:2 12:2 12:2 12:2 12:2 12:2 12:2 12:2 12:2 12:2 12:2 12:2 12:2 12:2 12:2 12:2 12:2 12:2 12:2 12:2 12:2 12:2 12:2 12:2 12:2 12:2 12:2 12:2 12:2 12:2 12:2 12:2 12:2 12:2 12:2 12:2 12:2 12:2 12:2 12:2 12:2 12:2 12:2 12:2
12:2 12:2 0:1 0:1 0:1 0:1 0:1 0:1 0:1 0:1 0:1 0:1 12:2 12:2 12:2 12:2 12:2 12:2 12:2 12:2 12:2 12:2 12:2 12:2 12:2 12:2 12:2 12:2 12:2 12:2 12:2 12:2 12:2 12:2 12:2 12:2 12:2 12:2 12:2 12:2 12:2 12:2 12:2 12:2 12:2 12:2 12:2 12:2 12:2 12:2 12:2 12:2 12:2 12:2 12:2 12:2 12:2 12:2 12:2 12:2 12:2 12:2 12:2 12:2 12:2 12:2 12:2 12:2 12:2 12:2 12:2 12:2 12:2 12:2 12:2 12:2 12:2 12:2 12:2 12:2
12:2 12:2 0:1 0:1 0:1 0:1 0:1 0:1 0:1 0:1 0:1 0:1 12:2 12:2 12:2 12:2 12:2 12:2 12:2 12:2 12:2 12:2 12:2 12:2 12:2 12:2 12:2 12:2 12:2 12:2 12:2 12:2 12:2 12:2 12:2 12:2 12:2 12:2 12:2 12:2 12:2 12:2 12:2 12:2 12:2 12:2 12:2 12:2 12:2 12:2 12:2 12:2 12:2 12:2 12:2 12:2 12:2 12:2 12:2 12:2 12:2 12:2 12:2 12:2 12:2 12:2 12:2 12:2 12:2 12:2 12:2 12:2 12:2 12:2 12:2 12:2 12:2 12:2 12:2 12:2
12:2 12:2 0:1 0:1 0:1 0:1 0:1 0:1 0:1 0:1 0:1 0:1 12:2 12:2 12:2 12:2 12:2 12:2 12:2 12:2 12:2 12:2 12:2 12:2 12:2 12:2 12:2 12:2 12:2 12:2 12:2 12:2 12:2 12:2 12:2 12:2 12:2 12:2 12:2 12:2 12:2 12:2 12:2 12:2 12:2 12:2 12:2 12:2 12:2 12:2 12:2 12:2 12:2 12:2 12:2 12:2 12:2 12:2 12:2 12:2 12:2 12:2 12:2 12:2 12:2 12:2 12:2 12:2 12:2 12:2 12:2 12:2 12:2 12:2 12:2 12:2 12:2 12:2 12:2 12:2
12:2 12:2 0:1 0:1 0:1 0:1 0:1 0:1 0:1 0:1 0:1 0:1 12:2 12:2 12:2 12:2 12:2 12:2 12:2 12:2 12:2 12:2 12:2 12:2 12:2 12:2 12:2 12:2 12:2 12:2 12:2 12:2 12:2 12:2 12:2 12:2 12:2 12:2 12:2 12:2 12:2 12:2 12:2 12:2 12:2 12:2 12:2 12:2 12:2 12:2 12:2 12:2 12:2 12:2 12:2 12:2 12:2 12:2 12:2 12:2 12:2 12:2 12:2 12:2 12:2 12:2 12:2 12:2 12:2 12:2 12:2 12:2 12:2 12:2 12:2 12:2 12:2 12:2 12:2 12:2
12:2 12:2 0:1 0:1 0:1 0:1 0:1 0:1 0:1 0:1 0:1 0:1 12:2 12:2 12:2 12:2 12:2 12:2 12:2 12:2 12:2 12:2 12:2 12:2 12:2 12:2 12:2 12:2 12:2 12:2 12:2 12:2 12:2 12:2 12:2 12:2 12:2 12:2 12:2 12:2 12:2 12:2 12:2 12:2 12:2 12:2 12:2 12:2 12:2 12:2 12:2 12:2 12:2 12:2 12:2 12:2 12:2 12:2 12:2 12:2 12:2 12:2 12:2 12:2 12:2 12:2 12:2 12:2 12:2 12:2 12:2 12:2 12:2 12:2 12:2 12:2 12:2 12:2 12:2 12:2
12:2 12:2 0:1 0:1 0:1 0:1 0:1 0:1 0:1 0:1 0:1 0:1 0:1 0:1 0:1 0:1 0:1 0:1 0:1 0:1 0:1 0:1 0:1 0:1 0:1 0:1 0:1 0:1 0:1 0:1 0:1 0:1 0:1 0:1 0:1 0:1 0:1 0:1 0:1 0:1 0:1 0:1 0:1 0:1 0:1 0:1 0:1 0:1 0:1 0:1 0:1 0:1 0:1 0:1 0:1 0:1 0:1 0:1 0:1 0:1 0:1 0:1 0:1 0:1 0:1 0:1 0:1 0:1 0:1 0:1 0:1 0:1 0:1 0:1 0:1 0:1 0:1 0:1 0:1 0:1
12:2 12:2 0:1 0:1 0:1 0:1 0:1 0:1 0:1 0:1 0:1 0:1 0:1 0:1 0:1 0:1 0:1 0:1 0:1 0:1 0:1 0:1 0:1 0:1 0:1 0:1 0:1 0:1 0:1 0:1 0:1 0:1 0:1 0:1 0:1 0:1 0:1 0:1 0:1 0:1 0:1 0:1 0:1 0:1 0:1 0:1 0:1 0:1 0:1 0:1 0:1 0:1 0:1 0:1 0:1 0:1 0:1 0:1 0:1 0:1 0:1 0:1 0:1 0:1 0:1 0:1 0:1 0:1 0:1 0:1 0:1 0:1 0:1 0:1 0:1 0:1 0:1 0:1 0:1 0:1
12:2 12:2 0:1 0:1 0:1 0:1 0:1 0:1 0:1 0:1 0:1 0:1 0:1 0:1 0:1 0:1 0:1 0:1 0:1 0:1 0:1 0:1 0:1 0:1 0:1 0:1 0:1 0:1 0:1 0:1 0:1 0:1 0:1 0:1 0:1 0:1 0:1 0:1 0:1 0:1 0:1 0:1 0:1 0:1 0:1 0:1 0:1 0:1 0:1 0:1 0:1 0:1 0:1 0:1 0:1 0:1 0:1 0:1 0:1 0:1 0:1 0:1 0:1 0:1 0:1 0:1 0:1 0:1 0:1 0:1 0:1 0:1 0:1 0:1 0:1 0:1 0:1 0:1 0:1 0:1
12:2 12:2 0:1 0:1 0:1 0:1 0:1 0:1 0:1 0:1 0:1 0:1 0:1 0:1 0:1 0:1 0:1 0:1 0:1 0:1 0:1 0:1 0:1 0:1 0:1 0:1 0:1 0:1 0:1 0:1 0:1 0:1 0:1 0:1 11:1 11:1 11:1 0:1 0:1 11:1 11:1 11:1 11:1 11:1 0:1 0:1 11:1 11:1 11:1 11:1 0:1 11:1 0:1 0:1 11:1 0:1 11:1 11:1 11:1 0:1 0:1 0:1 0:1 0:1 0:1 0:1 0:1 0:1 0:1 0:1 0:1 0:1 0:1 0:1 0:1 0:1 0:1 0:1 0:1 0:1
12:2 12:2 0:1 0:1 0:1 0:1 0:1 0:1 0:1 0:1 0:1 0:1 0:1 0:1 0:1 0:1 0:1 0:1 0:1 0:1 0:1 0:1 0:1 0:1 0:1 0:1 0:1 0:1 0:1 0:1 0:1 0:1 0:1 0:1 11:1 0:1 0:1 11:1 0:1 0:1 0:1 11:1 0:1 0:1 0:1 11:1 0:1 0:1 0:1 0:1 0:1 11:1 0:1 0:1 11:1 0:1 0:1 11:1 0:1 0:1 0:1 0:1 0:1 0:1 0:1 0:1 0:1 0:1 0:1 0:1 0:1 0:1 0:1 0:1 0:1 0:1 0:1 0:1 0:1 0:1
12:2 12:2 0:1 0:1 0:1 0:1 0:1 0:1 0:1 0:1 0:1 0:1 0:1 0:1 0:1 0:1 0:1 0:1 0:1 0:1 0:1 0:1 0:1 0:1 0:1 0:1 0:1 0:1 0:1 0:1 0:1 0:1 0:1 0:1 11:1 0:1 0:1 11:1 0:1 0:1 0:1 11:1 0:1 0:1 0:1 11:1 0:1 0:1 0:1 0:1 0:1 11:1 11:1 11:1 11:1 0:1 0:1 11:1 0:1 0:1 0:1 0:1 0:1 0:1 0:1 0:1 0:1 0:1 0:1 0:1 0:1 0:1 0:1 0:1 0:1 0:1 0:1 0:1 0:1 0:1
12:2 12:2 0:1 0:1 0:1 0:1 0:1 0:1 0:1 0:1 0:1 0:1 0:1 0:1 0:1 0:1 0:1 0:1 0:1 0:1 0:1 0:1 0:1 0:1 0:1 0:1 0:1 0:1 0:1 0:1 0:1 0:1 0:1 0:1 11:1 11:1 11:1 0:1 0:1 0:1 0:1 11:1 0:1 0:1 0:1 11:1 0:1 11:1 11:1 0:1 0:1 11:1 11:1 11:1 11:1 0:1 0:1 11:1 0:1 0:1 0:1 0:1 0:1 0:1 0:1 0:1 0:1 0:1 0:1 0:1 0:1 0:1 0:1 0:1 0:1 0:1 0:1 0:1 0:1 0:1
12:2 12:2 0:1 0:1 0:1 0:1 0:1 0:1 0:1 0:1 0:1 0:1 0:1 0:1 0:1 0:1 0:1 0:1 0:1 0:1 0:1 0:1 0:1 0:1 0:1 0:1 0:1 0:1 0:1 0:1 0:1 0:1 0:1 0:1 11:1 0:1 0:1 11:1 0:1 0:1 0:1 11:1 0:1 0:1 0:1 11:1 0:1 0:1 0:1 11:1 0:1 11:1 0:1 0:1 11:1 0:1 0:1 11:1 0:1 0:1 0:1 0:1 0:1 0:1 0:1 0:1 0:1 0:1 0:1 0:1 0:1 0:1 0:1 0:1 0:1 0:1 0:1 0:1 0:1 0:1
12:2 12:2 0:1 0:1 0:1 0:1 0:1 0:1 0:1 0:1 0:1 0:1 0:1 0:1 0:1 0:1 0:1 0:1 0:1 0:1 0:1 0:1 0:1 0:1 0:1 0:1 0:1 0:1 0:1 0:1 0:1 0:1 0:1 0:1 11:1 0:1 0:1 11:1 0:1 0:1 0:1 11:1 0:1 0:1 0:1 11:1 0:1 0:1 0:1 11:1 0:1 11:1 0:1 0:1 11:1 0:1 0:1 11:1 0:1 0:1 0:1 0:1 0:1 0:1 0:1 0:1 0:1 0:1 0:1 0:1 0:1 0:1 0:1 0:1 0:1 0:1 0:1 0:1 0:1 0:1
12:2 12:2 0:1 0:1 0:1 0:1 0:1 0:1 0:1 0:1 0:1 0:1 0:1 0:1 0:1 0:1 0:1 0:1 0:1 0:1 0:1 0:1 0:1 0:1 0:1 0:1 0:1 0:1 0:1 0:1 0:1 0:1 0:1 0:1 11:1 0:1 0:1 11:1 0:1 11:1 11:1 11:1 11:1 11:1 0:1 0:1 11:1 11:1 11:1 0:1 0:1 11:1 0:1 0:1 11:1 0:1 0:1 11:1 0:1 0:1 0:1 0:1 0:1 0:1 0:1 0:1 0:1 0:1 0:1 0:1 0:1 0:1 0:1 0:1 0:1 0:1 0:1 0:1 0:1 0:1
12:2 12:2 0:1 0:1 0:1 0:1 0:1 0:1 0:1 0:1 0:1 0:1 0:1 0:1 0:1 0:1 0:1 0:1 0:1 0:1 0:1 0:1 0:1 0:1 0:1 0:1 0:1 0:1 0:1 0:1 0:1 0:1 0:1 0:1 0:1 0:1 0:1 0:1 0:1 0:1 0:1 0:1 0:1 0:1 0:1 0:1 0:1 0:1 0:1 0:1 0:1 0:1 0:1 0:1 0:1 0:1 0:1 0:1 0:1 0:1 0:1 0:1 0:1 0:1 0:1 0:1 0:1 0:1 0:1 0:1 0:1 0:1 0:1 0:1 0:1 0:1 0:1 0:1 0:1 0:1
12:2 12:2 0:1 0:1 0:1 0:1 0:1 0:1 0:1 0:1 0:1 0:1 0:1 0:1 0:1 0:1 0:1 0:1 0:1 0:1 0:1 0:1 0:1 0:1 0:1 0:1 0:1 0:1 0:1 0:1 0:1 0:1 0:1 0:1 0:1 0:1 0:1 0:1 0:1 0:1 0:1 0:1 0:1 0:1 0:1 0:1 0:1 0:1 0:1 0:1 0:1 0:1 0:1 0:1 0:1 0:1 0:1 0:1 0:1 0:1 0:1 0:1 0:1 0:1 0:1 0:1 0:1 0:1 0:1 0:1 0:1 0:1 0:1 0:1 0:1 0:1 0:1 0:1 0:1 0:1
12:2 12:2 0:1 0:1 0:1 0:1 0:1 0:1 0:1 0:1 0:1 0:1 0:1 0:1 0:1 0:1 0:1 0:1 0:1 0:1 0:1 0:1 0:1 0:1 0:1 0:1 0:1 0:1 0:1 0:1 0:1 0:1 0:1 0:1 0:1 0:1 0:1 0:1 0:1 0:1 0:1 0:1 0:1 0:1 0:1 0:1 0:1 0:1 0:1 0:1 0:1 0:1 0:1 0:1 0:1 0:1 0:1 0:1 0:1 0:1 0:1 0:1 0:1 0:1 0:1 0:1 0:1 0:1 0:1 0:1 0:1 0:1 0:1 0:1 0:1 0:1 0:1 0:1 0:1 0:1
12:2 12:2 0:1 0:1 0:1 0:1 0:1 0:1 0:1 0:1 0:1 0:1 0:1 0:1 0:1 0:1 0:1 0:1 0:1 0:1 0:1 0:1 0:1 0:1 0:1 0:1 0:1 0:1 0:1 0:1 0:1 0:1 0:1 0:1 0:1 0:1 0:1 0:1 0:1 0:1 0:1 0:1 0:1 0:1 0:1 0:1 0:1 0:1 0:1 0:1 0:1 0:1 0:1 0:1 0:1 0:1 0:1 0:1 0:1 0:1 0:1 0:1 0:1 0:1 0:1 0:1 0:1 0:1 0:1 0:1 0:1 0:1 0:1 0:1 0:1 0:1 0:1 0:1 0:1 0:1
12:2 12:2 0:1 0:1 0:1 0:1 0:1 0:1 0:1 0:1 0:1 0:1 0:1 0:1 0:1 0:1 0:1 0:1 0:1 0:1 0:1 0:1 0:1 0:1 0:1 0:1 0:1 0:1 0:1 0:1 0:1 0:1 0:1 0:1 0:1 0:1 0:1 0:1 0:1 0:1 0:1 0:1 0:1 0:1 0:1 0:1 0:1 0:1 0:1 0:1 0:1 0:1 0:1 0:1 0:1 0:1 0:1 0:1 0:1 0:1 0:1 0:1 0:1 0:1 0:1 0:1 0:1 0:1 0:1 0:1 0:1 0:1 0:1 0:1 0:1 0:1 0:1 0:1 0:1 0:1
12:2 12:2 0:1 0:1 0:1 0:1 0:1 0:1 0:1 0:1 0:1 0:1 0:1 0:1 0:1 0:1 0:1 0:1 0:1 0:1 0:1 0:1 0:1 0:1 0:1 0:1 0:1 0:1 0:1 0:1 0:1 0:1 0:1 0:1 0:1 0:1 0:1 0:1 0:1 0:1 0:1 0:1 0:1 0:1 0:1 0:1 0:1 0:1 0:1 0:1 0:1 0:1 0:1 0:1 0:1 0:1 0:1 0:1 0:1 0:1 0:1 0:1 0:1 0:1 0:1 0:1 0:1 0:1 0:1 0:1 0:1 0:1 0:1 0:1 0:1 0:1 0:1 0:1 0:1 0:1
12:2 12:2 0:1 0:1 0:1 0:1 0:1 0:1 0:1 0:1 0:1 0:1 0:1 0:1 0:1 0:1 0:1 0:1 0:1 0:1 0:1 0:1 0:1 0:1 0:1 0:1 0:1 0:1 0:1 0:1 0:1 0:1 0:1 0:1 0:1 0:1 0:1 0:1 0:1 0:1 0:1 0:1 0:1 0:1 0:1 0:1 0:1 0:1 0:1 0:1 0:1 0:1 0:1 0:1 0:1 0:1 0:1 0:1 0:1 0:1 0:1 0:1 0:1 0:1 0:1 0:1 0:1 0:1 0:1 0:1 0:1 0:1 0:1 0:1 0:1 0:1 0:1 0:1 0:1 0:1
12:2 12:2 0:1 0:1 0:1 0:1 0:1 0:1 0:1 0:1 0:1 0:1 0:1 0:1 0:1 0:1 0:1 0:1 0:1 0:1 0:1 0:1 0:1 0:1 0:1 0:1 0:1 0:1 0:1 0:1 0:1 0:1 0:1 0:1 0:1 0:1 0:1 0:1 0:1 0:1 0:1 0:1 0:1 0:1 0:1 0:1 0:1 0:1 0:1 0:1 0:1 0:1 0:1 0:1 0:1 0:1 0:1 0:1 0:1 0:1 0:1 0:1 0:1 0:1 0:1 0:1 0:1 0:1 0:1 0:1 0:1 0:1 0:1 0:1 0:1 0:1 0:1 0:1 0:1 0:1
12:2 12:2 0:1 0:1 0:1 0:1 0:1 0:1 0:1 0:1 0:1 0:1 0:1 0:1 0:1 0:1 0:1 0:1 0:1 0:1 0:1 0:1 0:1 0:1 0:1 0:1 0:1 0:1 0:1 0:1 0:1 0:1 0:1 0:1 0:1 0:1 0:1 0:1 0:1 0:1 0:1 0:1 0:1 0:1 0:1 0:1 0:1 0:1 0:1 0:1 0:1 0:1 0:1 0:1 0:1 0:1 0:1 0:1 0:1 0:1 0:1 0:1 0:1 0:1 0:1 0:1 0:1 0:1 0:1 0:1 0:1 0:1 0:1 0:1 0:1 0:1 0:1 0:1 0:1 0:1
12:2 12:2 12:2 12:2 12:2 12:2 12:2 12:2 12:2 12:2 12:2 12:2 12:2 12:2 12:2 12:2 12:2 12:2 12:2 12:2 12:2 12:2 12:2 12:2 12:2 12:2 12:2 12:2 12:2 12:2 12:2 12:2 12:2 12:2 12:2 12:2 12:2 12:2 12:2 12:2 12:2 12:2 12:2 12:2 12:2 12:2 12:2 12:2 12:2 12:2 12:2 12:2 12:2 12:2 12:2 12:2 12:2 12:2 12:2 12:2 12:2 12:2 12:2 12:2 12:2 12:2 12:2 12:2 12:2 12:2 12:2 12:2 12:2 12:2 12:2 12:2 12:2 12:2 12:2 12:2
12:2 12:2 12:2 12:2 12:2 12:2 12:2 12:2 12:2 12:2 12:2 12:2 12:2 12:2 12:2 12:2 12:2 12:2 12:2 12:2 12:2 12:2 12:2 12:2 12:2 12:2 12:2 12:2 12:2 12:2 12:2 12:2 12:2 12:2 12:2 12:2 12:2 12:2 12:2 12:2 12:2 12:2 12:2 12:2 12:2 12:2 12:2 12:2 12:2 12:2 12:2 12:2 12:2 12:2 12:2 12:2 12:2 12:2 12:2 12:2 12:2 12:2 12:2 12:2 12:2 12:2 12:2 12:2 12:2 12:2 12:2 12:2 12:2 12:2 12:2 12:2 12:2 12:2 12:2 12:2
12:2 12:2 12:2 12:2 12:2 12:2 12:2 12:2 12:2 12:2 12:2 12:2 12:2 12:2 12:2 12:2 12:2 12:2 12:2 12:2 12:2 12:2 12:2 12:2 12:2 12:2 12:2 12:2 12:2 12:2 12:2 12:2 12:2 12:2 12:2 12:2 12:2 12:2 12:2 12:2 12:2 12:2 12:2 12:2 12:2 12:2 12:2 12:2 12:2 12:2 12:2 12:2 12:2 12:2 12:2 12:2 12:2 12:2 12:2 12:2 12:2 12:2 12:2 12:2 12:2 12:2 12:2 12:2 12:2 12:2 12:2 12:2 12:2 12:2 12:2 12:2 12:2 12:2 12:2 12:2
12:2 12:2 12:2 12:2 12:2 12:2 12:2 12:2 12:2 12:2 12:2 12:2 12:2 12:2 12:2 12:2 12:2 12:2 12:2 12:2 12:2 12:2 12:2 12:2 12:2 12:2 12:2 12:2 12:2 12:2 12:2 12:2 12:2 12:2 12:2 12:2 12:2 12:2 12:2 12:2 12:2 12:2 12:2 12:2 12:2 12:2 12:2 12:2 12:2 12:2 12:2 12:2 12:2 12:2 12:2 12:2 12:2 12:2 12:2 12:2 12:2 12:2 12:2 12:2 12:2 12:2 12:2 12:2 12:2 12:2 12:2 12:2 12:2 12:2 12:2 12:2 12:2 12:2 12:2 12:2
12:2 12:2 12:2 12:2 12:2 12:2 12:2 12:2 12:2 12:2 12:2 12:2 12:2 12:2 12:2 12:2 12:2 12:2 12:2 12:2 12:2 12:2 12:2 12:2 12:2 12:2 12:2 12:2 12:2 12:2 12:2 12:2 12:2 12:2 12:2 12:2 12:2 12:2 12:2 12:2 12:2 12:2 12:2 12:2 12:2 12:2 12:2 12:2 12:2 12:2 12:2 12:2 12:2 12:2 12:2 12:2 12:2 12:2 12:2 12:2 12:2 12:2 12:2 12:2 12:2 12:2 12:2 12:2 12:2 12:2 12:2 12:2 12:2 12:2 12:2 12:2 12:2 12:2 12:2 12:2
12:2 12:2 12:2 12:2 12:2 12:2 12:2 12:2 12:2 12:2 12:2 12:2 12:2 12:2 12:2 12:2 12:2 12:2 12:2 12:2 12:2 12:2 12:2 12:2 12:2 12:2 12:2 12:2 12:2 12:2 12:2 12:2 12:2 12:2 12:2 12:2 12:2 12:2 12:2 12:2 12:2 12:2 12:2 12:2 12:2 12:2 12:2 12:2 12:2 12:2 12:2 12:2 12:2 12:2 12:2 12:2 12:2 12:2 12:2 12:2 12:2 12:2 12:2 12:2 12:2 12:2 12:2 12:2 12:2 12:2 12:2 12:2 12:2 12:2 12:2 12:2 12:2 12:2 12:2 12:2
12:2 12:2 12:2 12:2 12:2 12:2 12:2 12:2 12:2 12:2 12:2 12:2 12:2 12:2 12:2 12:2 12:2 12:2 12:2 12:2 12:2 12:2 12:2 12:2 12:2 12:2 12:2 12:2 12:2 12:2 12:2 12:2 12:2 12:2 12:2 12:2 12:2 12:2 12:2 12:2 12:2 12:2 12:2 12:2 12:2 12:2 12:2 12:2 12:2 12:2 12:2 12:2 12:2 12:2 12:2 12:2 12:2 12:2 12:2 12:2 12:2 12:2 12:2 12:2 12:2 12:2 12:2 12:2 12:2 12:2 12:2 12:2 12:2 12:2 12:2 12:2 12:2 12:2 12:2 12:2
12:2 12:2 12:2 12:2 12:2 12:2 12:2 12:2 12:2 12:2 12:2 12:2 12:2 12:2 12:2 12:2 12:2 12:2 12:2 12:2 12:2 12:2 12:2 12:2 12:2 12:2 12:2 12:2 12:2 12:2 12:2 12:2 12:2 12:2 12:2 12:2 12:2 12:2 12:2 12:2 12:2 12:2 12:2 12:2 12:2 12:2 12:2 12:2 12:2 12:2 12:2 12:2 12:2 12:2 12:2 12:2 12:2 12:2 12:2 12:2 12:2 12:2 12:2 12:2 12:2 12:2 12:2 12:2 12:2 12:2 12:2 12:2 12:2 12:2 12:2 12:2 12:2 12:2 12:2 12:2
12:2 12:2 12:2 12:2 12:2 12:2 12:2 12:2 12:2 12:2 12:2 12:2 12:2 12:2 12:2 12:2 12:2 12:2 12:2 12:2 12:2 12:2 12:2 12:2 12:2 12:2 12:2 12:2 12:2 12:2 12:2 12:2 12:2 12:2 12:2 12:2 12:2 12:2 12:2 12:2 12:2 12:2 12:2 12:2 12:2 12:2 12:2 12:2 12:2 12:2 12:2 12:2 12:2 12:2 12:2 12:2 12:2 12:2 12:2 12:2 12:2 12:2 12:2 12:2 12:2 12:2 12:2 12:2 12:2 12:2 12:2 12:2 12:2 12:2 12:2 12:2 12:2 12:2 12:2 12:2
12:2 12:2 12:2 12:2 12:2 12:2 12:2 12:2 12:2 12:2 12:2 12:2 12:2 12:2 12:2 12:2 12:2 12:2 12:2 12:2 12:2 12:2 12:2 12:2 12:2 12:2 12:2 12:2 12:2 12:2 12:2 12:2 12:2 12:2 12:2 12:2 12:2 12:2 12:2 12:2 12:2 12:2 12:2 12:2 12:2 12:2 12:2 12:2 12:2 12:2 12:2 12:2 12:2 12:2 12:2 12:2 12:2 12:2 12:2 12:2 12:2 12:2 12:2 12:2 12:2 12:2 12:2 12:2 12:2 12:2 12:2 12:2 12:2 12:2 12:2 12:2 12:2 12:2 12:2 12:2