
13:2 13:2 13:2 13:2 13:2 13:2 13:2 13:2 13:2 13:2 13:2 13:2 13:2 13:2 13:2 13:2 13:2 13:2 13:2 13:2 13:2 13:2 13:2 13:2 13:2 13:2 13:2 13:2 13:2 13:2 13:2 13:2 13:2 13:2 13:2 13:2 13:2 13:2 13:2 13:2 13:2 13:2 13:2 13:2 13:2 13:2 13:2 13:2 13:2 13:2 13:2 13:2 13:2 13:2 13:2 13:2 13:2 13:2 13:2 13:2 13:2 13:2 13:2 13:2 13:2 13:2 13:2 13:2 13:2 13:2 13:2 13:2 13:2 13:2 13:2 13:2 13:2 13:2 13:2 13:2
0:1 0:1 0:1 0:1 0:1 0:1 0:1 0:1 0:1 0:1 0:1 0:1 0:1 0:1 0:1 0:1 0:1 0:1 0:1 0:1 0:1 0:1 0:1 0:1 0:1 0:1 0:1 0:1 0:1 0:1 0:1 0:1 0:1 0:1 0:1 0:1 0:1 0:1 0:1 0:1 0:1 0:1 0:1 0:1 0:1 0:1 0:1 0:1 0:1 0:1 0:1 0:1 0:1 0:1 0:1 0:1 0:1 0:1 0:1 0:1 0:1 0:1 0:1 0:1 0:1 0:1 0:1 0:1 0:1 0:1 0:1 0:1 0:1 0:1 0:1 0:1 0:1 0:1 0:1 0:1 
0:1 0:1 0:1 0:1 0:1 0:1 0:1 0:1 0:1 0:1 0:1 0:1 0:1 0:1 0:1 0:1 0:1 0:1 0:1 0:1 0:1 0:1 0:1 0:1 0:1 0:1 0:1 0:1 0:1 0:1 0:1 0:1 0:1 0:1 0:1 0:1 0:1 0:1 0:1 0:1 0:1 0:1 0:1 0:1 0:1 0:1 0:1 0:1 0:1 0:1 0:1 0:1 0:1 0:1 0:1 0:1 0:1 0:1 0:1 0:1 0:1 0:1 0:1 0:1 0:1 0:1 0:1 0:1 0:1 0:1 0:1 0:1 0:1 0:1 0:1 0:1 0:1 0:1 0:1 0:1 
0:1 0:1 0:1 0:1 0:1 0:1 0:1 0:1 0:1 0:1 0:1 0:1 0:1 0:1 0:1 0:1 0:1 0:1 0:1 0:1 0:1 0:1 0:1 0:1 0:1 0:1 0:1 0:1 0:1 0:1 0:1 0:1 0:1 0:1 0:1 0:1 0:1 0:1 0:1 0:1 0:1 0:1 0:1 0:1 0:1 0:1 0:1 0:1 0:1 0:1 0:1 0:1 0:1 0:1 0:1 0:1 0:1 0:1 0:1 0:1 0:1 0:1 0:1 0:1 0:1 0:1 0:1 0:1 0:1 0:1 0:1 0:1 0:1 0:1 0:1 0:1 0:1 0:1 0:1 0:1 
0:1 0:1 0:1 0:1 0:1 0:1 0:1 0:1 0:1 0:1 0:1 0:1 0:1 0:1 0:1 0:1 0:1 0:1 0:1 0:1 0:1 0:1 0:1 0:1 0:1 0:1 0:1 0:1 0:1 0:1 0:1 0:1 0:1 0:1 0:1 0:1 0:1 0:1 0:1 0:1 0:1 0:1 0:1 0:1 0:1 0:1 0:1 0:1 0:1 0:1 0:1 0:1 0:1 0:1 0:1 0:1 0:1 0:1 0:1 0:1 0:1 0:1 0:1 0:1 0:1 0:1 0:1 0:1 0:1 0:1 0:1 0:1 0:1 0:1 0:1 0:1 0:1 0:1 0:1 0:1 
0:1 0:1 0:1 0:1 0:1 0:1 0:1 0:1 0:1 0:1 0:1 0:1 0:1 0:1 0:1 0:1 0:1 0:1 0:1 0:1 0:1 0:1 0:1 0:1 0:1 0:1 0:1 0:1 0:1 0:1 0:1 0:1 0:1 0:1 0:1 0:1 0:1 0:1 0:1 0:1 0:1 0:1 0:1 0:1 0:1 0:1 0:1 0:1 0:1 0:1 0:1 0:1 0:1 0:1 0:1 0:1 0:1 0:1 0:1 0:1 0:1 0:1 0:1 0:1 0:1 0:1 0:1 0:1 0:1 0:1 0:1 0:1 0:1 0:1 0:1 0:1 0:1 0:1 0:1 0:1
13:2 13:2 13:2 13:2 13:2 13:2 13:2 13:2 13:2 13:2 13:2 13:2 13:2 13:2 13:2 13:2 13:2 13:2 13:2 13:2 13:2 13:2 13:2 13:2 13:2 13:2 13:2 13:2 13:2 13:2 13:2 13:2 13:2 13:2 13:2 13:2 13:2 13:2 13:2 13:2 0:1 0:1 0:1 0:1 0:1 0:1 0:1 13:2 13:2 13:2 13:2 13:2 13:2 13:2 13:2 13:2 13:2 13:2 13:2 13:2 13:2 13:2 13:2 13:2 13:2 13:2 13:2 13:2 13:2 13:2 13:2 13:2 13:2 13:2 13:2 13:2 13:2 13:2 13:2 13:2
0:1 0:1 0:1 0:1 0:1 0:1 0:1 0:1 0:1 0:1 0:1 0:1 0:1 0:1 0:1 0:1 0:1 0:1 0:1 0:1 0:1 0:1 0:1 0:1 0:1 0:1 0:1 0:1 0:1 0:1 0:1 0:1 0:1 0:1 0:1 0:1 0:1 0:1 0:1 0:1 0:1 0:1 0:1 0:1 0:1 0:1 0:1 0:1 0:1 0:1 0:1 0:1 0:1 0:1 0:1 0:1 0:1 0:1 0:1 0:1 0:1 0:1 0:1 0:1 0:1 0:1 0:1 0:1 0:1 0:1 0:1 0:1 0:1 0:1 0:1 0:1 0:1 0:1 0:1 0:1
0:1 0:1 0:1 0:1 0:1 0:1 0:1 0:1 0:1 0:1 0:1 0:1 0:1 0:1 0:1 0:1 0:1 0:1 0:1 23:1 0:1 0:1 0:1 0:1 23:1 23:1 0:1 0:1 0:1 0:1 23:1 0:1 0:1 0:1 0:1 0:1 0:1 0:1 0:1 0:1 0:1 0:1 0:1 0:1 0:1 0:1 0:1 0:1 0:1 0:1 0:1 0:1 0:1 0:1 0:1 0:1 0:1 0:1 23:1 0:1 0:1 23:1 0:1 23:1 23:1 23:1 0:1 0:1 0:1 0:1 0:1 0:1 0:1 0:1 0:1 0:1 0:1 0:1 0:1 0:1
0:1 0:1 0:1 0:1 0:1 0:1 0:1 0:1 0:1 0:1 0:1 0:1 0:1 0:1 0:1 0:1 0:1 0:1 23:1 0:1 23:1 0:1 0:1 0:1 23:1 23:1 0:1 0:1 23:1 0:1 23:1 0:1 0:1 0:1 0:1 0:1 0:1 0:1 0:1 0:1 0:1 0:1 0:1 23:1 0:1 0:1 0:1 0:1 0:1 0:1 0:1 0:1 0:1 0:1 0:1 0:1 0:1 23:1 0:1 0:1 23:1 0:1 0:1 23:1 0:1 0:1 23:1 0:1 0:1 0:1 0:1 0:1 0:1 0:1 0:1 0:1 0:1 0:1 0:1 0:1
0:1 0:1 0:1 0:1 0:1 0:1 0:1 0:1 0:1 0:1 0:1 0:1 0:1 0:1 0:1 0:1 0:1 0:1 23:1 0:1 23:1 0:1 0:1 0:1 23:1 0:1 23:1 0:1 23:1 0:1 23:1 0:1 0:1 0:1 0:1 0:1 0:1 0:1 0:1 0:1 0:1 0:1 0:1 23:1 0:1 0:1 0:1 0:1 0:1 0:1 0:1 0:1 0:1 0:1 0:1 0:1 23:1 0:1 0:1 23:1 0:1 0:1 0:1 23:1 0:1 0:1 23:1 0:1 0:1 0:1 0:1 0:1 0:1 0:1 0:1 0:1 0:1 0:1 0:1 0:1
0:1 0:1 0:1 0:1 0:1 0:1 0:1 0:1 0:1 0:1 0:1 0:1 0:1 0:1 0:1 0:1 0:1 23:1 0:1 0:1 0:1 23:1 0:1 0:1 23:1 0:1 23:1 0:1 23:1 0:1 23:1 0:1 0:1 0:1 0:1 0:1 0:1 0:1 0:1 0:1 0:1 23:1 23:1 23:1 23:1 23:1 0:1 0:1 0:1 0:1 0:1 0:1 0:1 0:1 0:1 0:1 0:1 23:1 0:1 0:1 23:1 0:1 0:1 23:1 23:1 0:1 23:1 0:1 0:1 0:1 0:1 0:1 0:1 0:1 0:1 0:1 0:1 0:1 0:1 0:1
0:1 0:1 0:1 0:1 0:1 0:1 0:1 0:1 0:1 0:1 0:1 0:1 0:1 0:1 0:1 0:1 0:1 23:1 23:1 23:1 23:1 23:1 0:1 0:1 23:1 0:1 23:1 0:1 23:1 0:1 23:1 0:1 0:1 0:1 0:1 0:1 0:1 0:1 0:1 0:1 0:1 0:1 0:1 23:1 0:1 0:1 0:1 0:1 0:1 0:1 0:1 0:1 0:1 0:1 0:1 0:1 0:1 0:1 23:1 0:1 0:1 23:1 0:1 23:1 0:1 23:1 0:1 0:1 0:1 0:1 0:1 0:1 0:1 0:1 0:1 0:1 0:1 0:1 0:1 0:1
0:1 0:1 0:1 0:1 0:1 0:1 0:1 0:1 0:1 0:1 0:1 0:1 0:1 0:1 0:1 0:1 23:1 0:1 0:1 0:1 0:1 0:1 23:1 0:1 23:1 0:1 0:1 23:1 23:1 0:1 23:1 0:1 0:1 0:1 0:1 0:1 0:1 0:1 0:1 0:1 0:1 0:1 0:1 23:1 0:1 0:1 0:1 0:1 0:1 0:1 0:1 0:1 0:1 0:1 0:1 0:1 0:1 23:1 0:1 0:1 23:1 0:1 0:1 23:1 0:1 0:1 23:1 0:1 0:1 0:1 0:1 0:1 0:1 0:1 0:1 0:1 0:1 0:1 0:1 0:1
0:1 0:1 0:1 0:1 0:1 0:1 0:1 0:1 0:1 0:1 0:1 0:1 0:1 0:1 0:1 0:1 23:1 0:1 0:1 0:1 0:1 0:1 23:1 0:1 23:1 0:1 0:1 0:1 23:1 0:1 23:1 0:1 0:1 0:1 0:1 0:1 0:1 0:1 0:1 0:1 0:1 0:1 0:1 0:1 0:1 0:1 0:1 0:1 0:1 0:1 0:1 0:1 0:1 0:1 0:1 0:1 23:1 0:1 0:1 23:1 0:1 0:1 0:1 23:1 0:1 0:1 0:1 23:1 0:1 0:1 0:1 0:1 0:1 0:1 0:1 0:1 0:1 0:1 0:1 0:1
13:2 13:2 0:1 0:1 0:1 0:1 0:1 0:1 0:1 0:1 0:1 0:1 0:1 0:1 0:1 0:1 0:1 0:1 0:1 0:1 0:1 0:1 0:1 0:1 0:1 0:1 0:1 0:1 0:1 0:1 0:1 0:1 0:1 0:1 0:1 0:1 0:1 0:1 0:1 0:1 0:1 13:2 0:1 0:1 0:1 0:1 0:1 0:1 0:1 0:1 0:1 0:1 0:1 0:1 0:1 0:1 0:1 0:1 0:1 0:1 0:1 0:1 0:1 0:1 0:1 0:1 0:1 0:1 0:1 0:1 0:1 0:1 0:1 0:1 0:1 0:1 0:1 0:1 0:1 0:1
13:2 13:2 13:2 0:1 0:1 0:1 0:1 0:1 0:1 0:1 0:1 0:1 0:1 0:1 0:1 0:1 0:1 0:1 0:1 0:1 0:1 0:1 0:1 0:1 0:1 0:1 0:1 0:1 0:1 0:1 0:1 0:1 0:1 0:1 0:1 0:1 0:1 0:1 0:1 0:1 0:1 13:2 13:2 0:1 0:1 0:1 0:1 0:1 0:1 0:1 0:1 0:1 0:1 0:1 0:1 0:1 0:1 0:1 0:1 0:1 0:1 0:1 0:1 0:1 0:1 0:1 0:1 0:1 0:1 0:1 0:1 0:1 0:1 0:1 0:1 0:1 0:1 0:1 0:1 0:1 
13:2 13:2 13:2 0:1 0:1 0:1 0:1 0:1 0:1 0:1 0:1 0:1 0:1 0:1 0:1 0:1 0:1 0:1 0:1 0:1 0:1 0:1 0:1 0:1 0:1 0:1 0:1 0:1 0:1 0:1 0:1 0:1 0:1 0:1 0:1 0:1 0:1 0:1 0:1 0:1 0:1 13:2 13:2 0:1 0:1 0:1 0:1 0:1 0:1 0:1 0:1 0:1 0:1 0:1 0:1 0:1 0:1 0:1 0:1 0:1 0:1 0:1 0:1 0:1 0:1 0:1 0:1 0:1 0:1 0:1 0:1 0:1 0:1 0:1 0:1 0:1 0:1 0:1 0:1 0:1
13:2 13:2 13:2 13:2 13:2 0:1 0:1 0:1 0:1 0:1 0:1 0:1 0:1 0:1 0:1 0:1 0:1 0:1 0:1 0:1 0:1 0:1 0:1 0:1 0:1 0:1 0:1 0:1 0:1 0:1 0:1 0:1 0:1 0:1 0:1 0:1 0:1 0:1 0:1 0:1 13:2 13:2 13:2 13:2 13:2 0:1 0:1 0:1 0:1 0:1 0:1 0:1 0:1 0:1 0:1 0:1 0:1 0:1 0:1 0:1 0:1 0:1 0:1 0:1 0:1 0:1 0:1 0:1 0:1 0:1 0:1 0:1 0:1 0:1 0:1 0:1 0:1 0:1 0:1 0:1 
13:2 13:2 13:2 13:2 13:2 13:2 0:1 0:1 0:1 0:1 0:1 0:1 0:1 0:1 0:1 0:1 0:1 0:1 0:1 0:1 0:1 0:1 0:1 0:1 0:1 0:1 0:1 0:1 0:1 0:1 0:1 0:1 0:1 0:1 0:1 0:1 0:1 0:1 0:1 0:1 13:2 13:2 13:2 13:2 13:2 13:2 0:1 0:1 0:1 0:1 0:1 0:1 0:1 0:1 0:1 0:1 0:1 0:1 0:1 0:1 0:1 0:1 0:1 0:1 0:1 0:1 0:1 0:1 0:1 0:1 0:1 0:1 0:1 0:1 0:1 0:1 0:1 0:1 0:1 0:1 
13:2 13:2 13:2 13:2 13:2 13:2 13:2 0:1 0:1 0:1 0:1 0:1 0:1 0:1 0:1 0:1 0:1 0:1 0:1 0:1 0:1 0:1 0:1 0:1 0:1 0:1 0:1 0:1 0:1 0:1 0:1 0:1 0:1 0:1 0:1 0:1 0:1 0:1 0:1 0:1 13:2 13:2 13:2 13:2 13:2 13:2 13:2 0:1 0:1 0:1 0:1 0:1 0:1 0:1 0:1 0:1 0:1 0:1 0:1 0:1 0:1 0:1 0:1 0:1 0:1 0:1 0:1 0:1 0:1 0:1 0:1 0:1 0:1 0:1 0:1 0:1 0:1 0:1 0:1 0:1 
13:2 13:2 13:2 13:2 13:2 13:2 13:2 13:2 0:1 0:1 0:1 0:1 0:1 0:1 0:1 0:1 0:1 0:1 0:1 0:1 0:1 0:1 0:1 0:1 0:1 0:1 0:1 0:1 0:1 0:1 0:1 0:1 0:1 0:1 0:1 0:1 0:1 0:1 0:1 0:1 13:2 13:2 13:2 13:2 13:2 13:2 13:2 13:2 0:1 0:1 0:1 0:1 0:1 0:1 0:1 0:1 0:1 0:1 0:1 0:1 0:1 0:1 0:1 0:1 0:1 0:1 0:1 0:1 0:1 0:1 0:1 0:1 0:1 0:1 0:1 0:1 0:1 0:1 0:1 0:1 
13:2 13:2 13:2 13:2 13:2 13:2 13:2 13:2 13:2 0:1 0:1 0:1 0:1 0:1 0:1 0:1 0:1 0:1 0:1 0:1 0:1 0:1 0:1 0:1 0:1 0:1 0:1 0:1 0:1 0:1 0:1 0:1 0:1 0:1 0:1 0:1 0:1 0:1 0:1 0:1 13:2 13:2 13:2 13:2 13:2 13:2 13:2 13:2 13:2 0:1 0:1 0:1 0:1 0:1 0:1 0:1 0:1 0:1 0:1 0:1 0:1 0:1 0:1 0:1 0:1 0:1 0:1 0:1 0:1 0:1 0:1 0:1 0:1 0:1 0:1 0:1 0:1 0:1 0:1 0:1 
13:2 13:2 13:2 13:2 13:2 13:2 13:2 13:2 13:2 13:2 0:1 0:1 0:1 0:1 0:1 0:1 0:1 0:1 0:1 0:1 0:1 0:1 0:1 0:1 0:1 0:1 0:1 0:1 0:1 0:1 0:1 0:1 0:1 0:1 0:1 0:1 0:1 0:1 0:1 13:2 13:2 13:2 13:2 13:2 13:2 13:2 13:2 13:2 13:2 13:2 0:1 0:1 0:1 0:1 0:1 0:1 0:1 0:1 0:1 0:1 0:1 0:1 0:1 0:1 0:1 0:1 0:1 0:1 0:1 0:1 0:1 0:1 0:1 0:1 0:1 0:1 0:1 0:1 0:1 0:1 
13:2 13:2 13:2 13:2 13:2 13:2 13:2 13:2 13:2 13:2 13:2 13:2 13:2 13:2 13:2 13:2 13:2 13:2 13:2 13:2 13:2 13:2 13:2 13:2 13:2 13:2 13:2 13:2 13:2 13:2 13:2 13:2 13:2 13:2 13:2 13:2 13:2 13:2 13:2 13:2 13:2 13:2 13:2 13:2 13:2 13:2 13:2 13:2 13:2 13:2 13:2 13:2 13:2 13:2 13:2 13:2 13:2 13:2 13:2 13:2 13:2 13:2 13:2 13:2 13:2 13:2 13:2 13:2 13:2 13:2 13:2 13:2 13:2 13:2 13:2 13:2 13:2 13:2 13:2 13:2 
13:2 13:2 13:2 13:2 13:2 13:2 13:2 13:2 13:2 13:2 13:2 13:2 13:2 13:2 13:2 13:2 13:2 13:2 13:2 13:2 13:2 13:2 13:2 13:2 13:2 13:2 13:2 13:2 13:2 13:2 13:2 13:2 13:2 13:2 13:2 13:2 13:2 13:2 13:2 13:2 13:2 13:2 13:2 13:2 13:2 13:2 13:2 13:2 13:2 13:2 13:2 13:2 13:2 13:2 13:2 13:2 13:2 13:2 13:2 13:2 13:2 13:2 13:2 13:2 13:2 13:2 13:2 13:2 13:2 13:2 13:2 13:2 13:2 13:2 13:2 13:2 13:2 13:2 13:2 13:2 
13:2 13:2 13:2 13:2 13:2 13:2 13:2 13:2 13:2 13:2 13:2 13:2 13:2 13:2 13:2 13:2 13:2 13:2 13:2 13:2 13:2 13:2 13:2 13:2 13:2 13:2 13:2 13:2 13:2 13:2 13:2 13:2 13:2 13:2 13:2 13:2 13:2 13:2 13:2 13:2 13:2 13:2 13:2 13:2 13:2 13:2 13:2 13:2 13:2 13:2 13:2 13:2 13:2 13:2 13:2 13:2 13:2 13:2 13:2 13:2 13:2 13:2 13:2 13:2 13:2 13:2 13:2 13:2 13:2 13:2 13:2 13:2 13:2 13:2 13:2 13:2 13:2 13:2 13:2 13:2 
13:2 13:2 13:2 13:2 13:2 13:2 13:2 13:2 13:2 13:2 13:2 13:2 13:2 13:2 13:2 13:2 13:2 13:2 13:2 13:2 13:2 13:2 13:2 13:2 13:2 13:2 13:2 13:2 13:2 13:2 13:2 13:2 13:2 13:2 13:2 13:2 13:2 13:2 13:2 13:2 13:2 13:2 13:2 13:2 13:2 13:2 13:2 13:2 13:2 13:2 13:2 13:2 13:2 13:2 13:2 13:2 13:2 13:2 13:2 13:2 13:2 13:2 13:2 13:2 13:2 13:2 13:2 13:2 13:2 13:2 13:2 13:2 13:2 13:2 13:2 13:2 13:2 13:2 13:2 13:2 
13:2 13:2 13:2 13:2 13:2 13:2 13:2 13:2 13:2 13:2 13:2 13:2 13:2 13:2 13:2 13:2 13:2 13:2 13:2 13:2 13:2 13:2 13:2 13:2 13:2 13:2 13:2 13:2 13:2 13:2 13:2 13:2 13:2 13:2 13:2 13:2 13:2 13:2 13:2 13:2 13:2 13:2 13:2 13:2 13:2 13:2 13:2 13:2 13:2 13:2 13:2 13:2 13:2 13:2 13:2 13:2 13:2 13:2 13:2 13:2 13:2 13:2 13:2 13:2 13:2 13:2 13:2 13:2 13:2 13:2 13:2 13:2 13:2 13:2 13:2 13:2 13:2 13:2 13:2 13:2 
13:2 13:2 13:2 13:2 13:2 13:2 13:2 13:2 13:2 13:2 13:2 13:2 13:2 13:2 13:2 13:2 13:2 13:2 13:2 13:2 13:2 13:2 13:2 13:2 13:2 13:2 13:2 13:2 13:2 13:2 13:2 13:2 13:2 13:2 13:2 13:2 13:2 13:2 13:2 13:2 13:2 13:2 13:2 13:2 13:2 13:2 13:2 13:2 13:2 13:2 13:2 13:2 13:2 13:2 13:2 13:2 13:2 13:2 13:2 13:2 13:2 13:2 13:2 13:2 13:2 13:2 13:2 13:2 13:2 13:2 13:2 13:2 13:2 13:2 13:2 13:2 13:2 13:2 13:2 13:2 
13:2 13:2 13:2 13:2 13:2 13:2 13:2 13:2 13:2 13:2 13:2 13:2 13:2 13:2 13:2 13:2 13:2 13:2 13:2 13:2 13:2 13:2 13:2 13:2 13:2 13:2 13:2 13:2 13:2 13:2 13:2 13:2 13:2 13:2 13:2 13:2 13:2 13:2 13:2 13:2 13:2 13:2 13:2 13:2 13:2 13:2 13:2 13:2 13:2 13:2 13:2 13:2 13:2 13:2 13:2 13:2 13:2 13:2 13:2 13:2 13:2 13:2 13:2 13:2 13:2 13:2 13:2 13:2 13:2 13:2 13:2 13:2 13:2 13:2 13:2 13:2 13:2 13:2 13:2 13:2 
13:2 13:2 13:2 13:2 13:2 13:2 13:2 13:2 13:2 13:2 13:2 13:2 13:2 13:2 13:2 13:2 13:2 13:2 13:2 13:2 13:2 13:2 13:2 13:2 13:2 13:2 13:2 13:2 13:2 13:2 13:2 13:2 13:2 13:2 13:2 13:2 13:2 13:2 13:2 13:2 13:2 13:2 13:2 13:2 13:2 13:2 13:2 13:2 13:2 13:2 13:2 13:2 13:2 13:2 13:2 13:2 13:2 13:2 13:2 13:2 13:2 13:2 13:2 13:2 13:2 13:2 13:2 13:2 13:2 13:2 13:2 13:2 13:2 13:2 13:2 13:2 13:2 13:2 13:2 13:2 
13:2 13:2 13:2 13:2 13:2 13:2 13:2 13:2 13:2 13:2 13:2 13:2 13:2 13:2 13:2 13:2 13:2 13:2 13:2 13:2 13:2 13:2 13:2 13:2 13:2 13:2 13:2 13:2 13:2 13:2 13:2 13:2 13:2 13:2 13:2 13:2 13:2 13:2 13:2 13:2 13:2 13:2 13:2 13:2 13:2 13:2 13:2 13:2 13:2 13:2 13:2 13:2 13:2 13:2 13:2 13:2 13:2 13:2 13:2 13:2 13:2 13:2 13:2 13:2 13:2 13:2 13:2 13:2 13:2 13:2 13:2 13:2 13:2 13:2 13:2 13:2 13:2 13:2 13:2 13:2 
13:2 13:2 13:2 13:2 13:2 13:2 13:2 13:2 13:2 13:2 13:2 13:2 13:2 13:2 13:2 13:2 13:2 13:2 13:2 13:2 13:2 13:2 13:2 13:2 13:2 13:2 13:2 13:2 13:2 13:2 13:2 13:2 13:2 13:2 13:2 13:2 13:2 13:2 13:2 13:2 13:2 13:2 13:2 13:2 13:2 13:2 13:2 13:2 13:2 13:2 13:2 13:2 13:2 13:2 13:2 13:2 13:2 13:2 13:2 13:2 13:2 13:2 13:2 13:2 13:2 13:2 13:2 13:2 13:2 13:2 13:2 13:2 13:2 13:2 13:2 13:2 13:2 13:2 13:2 13:2 
0:1 0:1 0:1 0:1 0:1 0:1 0:1 0:1 0:1 0:1 0:1 0:1 0:1 0:1 0:1 0:1 0:1 0:1 0:1 0:1 0:1 0:1 0:1 0:1 0:1 0:1 0:1 0:1 0:1 0:1 0:1 0:1 0:1 0:1 0:1 0:1 0:1 0:1 0:1 0:1 0:1 0:1 0:1 0:1 0:1 0:1 0:1 0:1 0:1 0:1 0:1 0:1 0:1 0:1 0:1 0:1 0:1 0:1 0:1 0:1 0:1 0:1 0:1 0:1 0:1 0:1 0:1 0:1 0:1 0:1 0:1 0:1 0:1 0:1 0:1 0:1 0:1 0:1 0:1 0:1 
0:1 0:1 0:1 0:1 0:1 0:1 0:1 0:1 0:1 0:1 0:1 0:1 0:1 0:1 0:1 0:1 0:1 0:1 0:1 0:1 0:1 0:1 0:1 0:1 0:1 0:1 0:1 0:1 0:1 0:1 0:1 0:1 0:1 0:1 0:1 0:1 0:1 0:1 0:1 0:1 0:1 0:1 0:1 0:1 0:1 0:1 0:1 0:1 0:1 0:1 0:1 0:1 0:1 0:1 0:1 0:1 0:1 0:1 0:1 0:1 0:1 0:1 0:1 0:1 0:1 0:1 0:1 0:1 0:1 0:1 0:1 0:1 0:1 0:1 0:1 0:1 0:1 0:1 0:1 0:1 
0:1 0:1 0:1 0:1 0:1 0:1 0:1 0:1 0:1 0:1 0:1 0:1 0:1 0:1 0:1 0:1 0:1 0:1 0:1 0:1 0:1 0:1 0:1 0:1 0:1 0:1 0:1 0:1 0:1 0:1 0:1 0:1 0:1 0:1 0:1 0:1 0:1 0:1 0:1 0:1 0:1 0:1 0:1 0:1 0:1 0:1 0:1 0:1 0:1 0:1 0:1 0:1 0:1 0:1 0:1 0:1 0:1 0:1 0:1 0:1 0:1 0:1 0:1 0:1 0:1 0:1 0:1 0:1 0:1 0:1 0:1 0:1 0:1 0:1 0:1 0:1 0:1 0:1 0:1 0:1 
0:1 0:1 0:1 0:1 0:1 0:1 0:1 0:1 0:1 0:1 0:1 0:1 0:1 0:1 0:1 0:1 0:1 0:1 0:1 0:1 0:1 0:1 0:1 0:1 0:1 0:1 0:1 0:1 0:1 0:1 0:1 0:1 0:1 0:1 0:1 0:1 0:1 0:1 0:1 0:1 0:1 0:1 0:1 0:1 0:1 0:1 0:1 0:1 0:1 0:1 0:1 0:1 0:1 0:1 0:1 0:1 0:1 0:1 0:1 0:1 0:1 0:1 0:1 0:1 0:1 0:1 0:1 0:1 0:1 0:1 0:1 0:1 0:1 0:1 0:1 0:1 0:1 0:1 0:1 0:1 
0:1 0:1 0:1 0:1 0:1 0:1 0:1 0:1 0:1 0:1 0:1 0:1 0:1 0:1 0:1 0:1 0:1 0:1 0:1 0:1 0:1 0:1 0:1 0:1 0:1 0:1 0:1 0:1 15:1 16:1 16:1 16:1 17:1 0:1 0:1 0:1 0:1 0:1 0:1 0:1 0:1 0:1 0:1 0:1 0:1 0:1 0:1 0:1 0:1 0:1 0:1 0:1 0:1 0:1 0:1 0:1 0:1 0:1 0:1 0:1 0:1 0:1 0:1 0:1 0:1 0:1 0:1 0:1 0:1 0:1 0:1 0:1 0:1 0:1 0:1 0:1 0:1 0:1 0:1 0:1 
0:1 0:1 0:1 0:1 0:1 0:1 0:1 0:1 0:1 0:1 0:1 0:1 0:1 0:1 0:1 0:1 0:1 0:1 0:1 0:1 0:1 0:1 0:1 0:1 0:1 0:1 0:1 0:1 18:1 19:1 20:1 21:1 22:1 0:1 0:1 0:1 0:1 0:1 0:1 0:1 0:1 0:1 0:1 0:1 0:1 0:1 0:1 0:1 0:1 0:1 0:1 0:1 0:1 0:1 0:1 0:1 0:1 0:1 0:1 0:1 0:1 0:1 0:1 0:1 0:1 0:1 0:1 0:1 0:1 0:1 0:1 0:1 0:1 0:1 0:1 0:1 0:1 0:1 0:1 0:1
0:1 0:1 0:1 0:1 0:1 0:1 0:1 0:1 0:1 0:1 0:1 0:1 0:1 0:1 0:1 0:1 0:1 0:1 0:1 0:1 0:1 0:1 0:1 0:1 0:1 0:1 0:1 0:1 0:1 0:1 0:1 0:1 0:1 0:1 0:1 0:1 0:1 0:1 0:1 0:1 0:1 0:1 0:1 0:1 0:1 0:1 0:1 0:1 0:1 0:1 0:1 0:1 0:1 0:1 0:1 0:1 0:1 0:1 0:1 0:1 0:1 0:1 0:1 0:1 0:1 0:1 0:1 0:1 0:1 0:1 0:1 0:1 0:1 0:1 0:1 0:1 0:1 0:1 0:1 0:1
0:1 0:1 0:1 0:1 0:1 0:1 0:1 0:1 0:1 0:1 0:1 0:1 0:1 0:1 0:1 0:1 0:1 0:1 0:1 0:1 0:1 0:1 0:1 0:1 0:1 0:1 0:1 0:1 0:1 0:1 0:1 0:1 0:1 0:1 0:1 0:1 0:1 0:1 0:1 0:1 0:1 0:1 0:1 0:1 0:1 0:1 0:1 0:1 0:1 0:1 0:1 0:1 0:1 0:1 0:1 0:1 0:1 0:1 0:1 0:1 0:1 0:1 0:1 0:1 0:1 0:1 0:1 0:1 0:1 0:1 0:1 0:1 0:1 0:1 0:1 0:1 0:1 0:1 0:1 0:1
0:1 0:1 0:1 0:1 0:1 0:1 0:1 0:1 0:1 0:1 0:1 0:1 0:1 0:1 0:1 0:1 0:1 0:1 0:1 0:1 0:1 0:1 0:1 0:1 0:1 0:1 0:1 0:1 0:1 0:1 0:1 0:1 0:1 0:1 0:1 0:1 0:1 0:1 0:1 0:1 0:1 0:1 0:1 0:1 0:1 0:1 0:1 0:1 0:1 0:1 0:1 0:1 0:1 0:1 0:1 0:1 0:1 0:1 0:1 0:1 0:1 0:1 0:1 0:1 0:1 0:1 0:1 0:1 0:1 0:1 0:1 0:1 0:1 0:1 0:1 0:1 0:1 0:1 0:1 0:1
0:1 0:1 0:1 0:1 0:1 0:1 0:1 0:1 0:1 0:1 0:1 0:1 0:1 0:1 0:1 0:1 0:1 0:1 0:1 0:1 0:1 0:1 0:1 0:1 0:1 0:1 0:1 0:1 0:1 0:1 0:1 0:1 0:1 0:1 0:1 0:1 0:1 0:1 0:1 0:1 0:1 0:1 0:1 0:1 0:1 0:1 0:1 0:1 0:1 0:1 0:1 0:1 0:1 0:1 0:1 0:1 0:1 0:1 0:1 0:1 0:1 0:1 0:1 0:1 0:1 0:1 0:1 0:1 15:1 16:1 17:1 0:1 0:1 0:1 0:1 0:1 0:1 0:1 0:1 0:1
0:1 0:1 0:1 0:1 0:1 0:1 0:1 0:1 0:1 0:1 0:1 0:1 0:1 0:1 0:1 0:1 0:1 0:1 0:1 0:1 0:1 0:1 0:1 0:1 0:1 0:1 0:1 0:1 0:1 0:1 0:1 0:1 0:1 0:1 0:1 0:1 0:1 0:1 0:1 0:1 0:1 0:1 0:1 0:1 0:1 0:1 0:1 0:1 0:1 0:1 0:1 0:1 0:1 0:1 0:1 0:1 0:1 0:1 0:1 0:1 0:1 0:1 0:1 0:1 0:1 0:1 0:1 0:1 18:1 20:1 22:1 0:1 0:1 0:1 0:1 0:1 0:1 0:1 0:1 0:1
13:2 0:1 0:1 0:1 0:1 0:1 0:1 0:1 0:1 0:1 0:1 0:1 0:1 0:1 0:1 0:1 0:1 0:1 0:1 0:1 0:1 0:1 0:1 0:1 0:1 0:1 0:1 0:1 0:1 0:1 0:1 0:1 0:1 0:1 0:1 0:1 0:1 0:1 0:1 0:1 0:1 0:1 0:1 0:1 0:1 0:1 0:1 0:1 0:1 0:1 0:1 0:1 0:1 0:1 0:1 0:1 0:1 0:1 0:1 0:1 0:1 0:1 0:1 0:1 0:1 0:1 0:1 0:1 0:1 0:1 0:1 0:1 0:1 0:1 0:1 0:1 0:1 0:1 0:1 0:1
13:2 0:1 0:1 0:1 0:1 0:1 0:1 0:1 0:1 0:1 0:1 0:1 0:1 0:1 0:1 0:1 0:1 0:1 0:1 0:1 0:1 0:1 0:1 0:1 0:1 0:1 0:1 0:1 0:1 0:1 0:1 0:1 0:1 0:1 0:1 0:1 0:1 0:1 0:1 0:1 0:1 0:1 0:1 0:1 0:1 0:1 0:1 0:1 0:1 0:1 0:1 0:1 0:1 0:1 0:1 0:1 0:1 0:1 0:1 0:1 0:1 0:1 0:1 0:1 0:1 0:1 0:1 0:1 0:1 0:1 0:1 0:1 0:1 0:1 0:1 0:1 0:1 0:1 0:1 0:1
13:2 0:1 0:1 0:1 0:1 0:1 0:1 0:1 0:1 0:1 0:1 0:1 0:1 0:1 0:1 0:1 0:1 15:1 16:1 17:1 0:1 0:1 0:1 0:1 0:1 0:1 0:1 0:1 0:1 0:1 0:1 0:1 0:1 0:1 0:1 0:1 0:1 0:1 0:1 0:1 0:1 0:1 0:1 0:1 0:1 0:1 0:1 0:1 0:1 15:1 16:1 16:1 17:1 0:1 0:1 0:1 0:1 0:1 0:1 0:1 0:1 0:1 0:1 0:1 0:1 0:1 0:1 0:1 0:1 0:1 0:1 0:1 0:1 0:1 0:1 0:1 0:1 0:1 0:1 0:1
13:2 0:1 0:1 0:1 0:1 0:1 0:1 0:1 0:1 0:1 0:1 0:1 0:1 0:1 0:1 0:1 0:1 18:1 20:1 21:1 0:1 0:1 0:1 0:1 0:1 0:1 0:1 0:1 0:1 0:1 0:1 0:1 0:1 0:1 0:1 0:1 0:1 0:1 0:1 0:1 0:1 0:1 0:1 0:1 0:1 0:1 0:1 0:1 0:1 18:1 19:1 20:1 22:1 0:1 0:1 0:1 0:1 0:1 0:1 0:1 0:1 0:1 0:1 0:1 0:1 0:1 0:1 0:1 0:1 0:1 0:1 0:1 0:1 0:1 0:1 0:1 0:1 0:1 0:1 0:1
13:2 13:2 0:1 0:1 0:1 0:1 0:1 0:1 0:1 0:1 0:1 0:1 0:1 0:1 0:1 0:1 0:1 0:1 0:1 0:1 0:1 0:1 0:1 0:1 0:1 0:1 0:1 0:1 0:1 0:1 0:1 0:1 0:1 0:1 0:1 0:1 0:1 0:1 0:1 0:1 13:2 13:2 0:1 0:1 0:1 0:1 0:1 0:1 0:1 0:1 0:1 0:1 0:1 0:1 0:1 0:1 0:1 0:1 0:1 0:1 0:1 0:1 0:1 0:1 0:1 0:1 0:1 0:1 0:1 0:1 0:1 0:1 0:1 0:1 0:1 0:1 0:1 0:1 0:1 0:1
13:2 13:2 13:2 0:1 0:1 0:1 0:1 0:1 0:1 0:1 0:1 0:1 0:1 0:1 0:1 0:1 0:1 0:1 0:1 0:1 0:1 0:1 0:1 0:1 0:1 0:1 0:1 0:1 0:1 0:1 0:1 0:1 0:1 0:1 0:1 0:1 0:1 0:1 0:1 0:1 13:2 13:2 13:2 0:1 0:1 0:1 0:1 0:1 0:1 0:1 0:1 0:1 0:1 0:1 0:1 0:1 0:1 0:1 0:1 0:1 0:1 0:1 0:1 0:1 0:1 0:1 0:1 0:1 0:1 0:1 0:1 0:1 0:1 0:1 0:1 0:1 0:1 0:1 0:1 0:1 
13:2 13:2 13:2 0:1 0:1 0:1 0:1 0:1 0:1 0:1 0:1 0:1 0:1 0:1 0:1 0:1 0:1 0:1 0:1 0:1 0:1 0:1 0:1 0:1 0:1 0:1 0:1 0:1 0:1 0:1 0:1 0:1 0:1 0:1 0:1 0:1 0:1 0:1 0:1 0:1 13:2 13:2 13:2 0:1 0:1 0:1 0:1 0:1 0:1 0:1 0:1 0:1 0:1 0:1 0:1 0:1 0:1 0:1 0:1 0:1 0:1 0:1 0:1 0:1 0:1 0:1 0:1 0:1 0:1 0:1 0:1 0:1 0:1 0:1 0:1 0:1 0:1 0:1 0:1 0:1
13:2 13:2 13:2 13:2 13:2 0:1 0:1 0:1 0:1 0:1 0:1 0:1 0:1 0:1 0:1 0:1 0:1 0:1 0:1 0:1 0:1 0:1 0:1 0:1 0:1 0:1 0:1 0:1 0:1 0:1 0:1 0:1 0:1 0:1 0:1 0:1 0:1 0:1 0:1 0:1 13:2 13:2 13:2 13:2 13:2 0:1 0:1 0:1 0:1 0:1 0:1 0:1 0:1 0:1 0:1 0:1 0:1 0:1 0:1 0:1 0:1 0:1 0:1 0:1 0:1 0:1 0:1 0:1 0:1 0:1 0:1 0:1 0:1 0:1 0:1 0:1 0:1 0:1 0:1 0:1 
13:2 13:2 13:2 13:2 13:2 13:2 0:1 0:1 0:1 0:1 0:1 0:1 0:1 0:1 0:1 0:1 0:1 0:1 0:1 0:1 0:1 0:1 0:1 0:1 0:1 0:1 0:1 0:1 0:1 0:1 0:1 0:1 0:1 0:1 0:1 0:1 0:1 0:1 0:1 0:1 13:2 13:2 13:2 13:2 13:2 13:2 0:1 0:1 0:1 0:1 0:1 0:1 0:1 0:1 0:1 0:1 0:1 0:1 0:1 0:1 0:1 0:1 0:1 0:1 0:1 0:1 0:1 0:1 0:1 0:1 0:1 0:1 0:1 0:1 0:1 0:1 0:1 0:1 0:1 0:1 
13:2 13:2 13:2 13:2 13:2 13:2 13:2 0:1 0:1 0:1 0:1 0:1 0:1 0:1 0:1 0:1 0:1 0:1 0:1 0:1 0:1 0:1 0:1 0:1 0:1 0:1 0:1 0:1 0:1 0:1 0:1 0:1 0:1 0:1 0:1 0:1 0:1 0:1 0:1 0:1 13:2 13:2 13:2 13:2 13:2 13:2 13:2 0:1 0:1 0:1 0:1 0:1 0:1 0:1 0:1 0:1 0:1 0:1 0:1 0:1 0:1 0:1 0:1 0:1 0:1 0:1 0:1 0:1 0:1 0:1 0:1 0:1 0:1 0:1 0:1 0:1 0:1 0:1 0:1 0:1 
13:2 13:2 13:2 13:2 13:2 13:2 13:2 13:2 0:1 0:1 0:1 0:1 0:1 0:1 0:1 0:1 0:1 0:1 0:1 0:1 0:1 0:1 0:1 0:1 0:1 0:1 0:1 0:1 0:1 0:1 0:1 0:1 0:1 0:1 0:1 0:1 0:1 0:1 0:1 0:1 13:2 13:2 13:2 13:2 13:2 13:2 13:2 13:2 0:1 0:1 0:1 0:1 0:1 0:1 0:1 0:1 0:1 0:1 0:1 0:1 0:1 0:1 0:1 0:1 0:1 0:1 0:1 0:1 0:1 0:1 0:1 0:1 0:1 0:1 0:1 0:1 0:1 0:1 0:1 0:1 
13:2 13:2 13:2 13:2 13:2 13:2 13:2 13:2 13:2 0:1 0:1 0:1 0:1 0:1 0:1 0:1 0:1 0:1 0:1 0:1 0:1 0:1 0:1 0:1 0:1 0:1 0:1 0:1 0:1 0:1 0:1 0:1 0:1 0:1 0:1 0:1 0:1 0:1 0:1 0:1 13:2 13:2 13:2 13:2 13:2 13:2 13:2 13:2 13:2 0:1 0:1 0:1 0:1 0:1 0:1 0:1 0:1 0:1 0:1 0:1 0:1 0:1 0:1 0:1 0:1 0:1 0:1 0:1 0:1 0:1 0:1 0:1 0:1 0:1 0:1 0:1 0:1 0:1 0:1 0:1 
13:2 13:2 13:2 13:2 13:2 13:2 13:2 13:2 13:2 13:2 0:1 0:1 0:1 0:1 0:1 0:1 0:1 0:1 0:1 0:1 0:1 0:1 0:1 0:1 0:1 0:1 0:1 0:1 0:1 0:1 0:1 0:1 0:1 0:1 0:1 0:1 0:1 0:1 0:1 0:1 13:2 13:2 13:2 13:2 13:2 13:2 13:2 13:2 13:2 13:2 0:1 0:1 0:1 0:1 0:1 0:1 0:1 0:1 0:1 0:1 0:1 0:1 0:1 0:1 0:1 0:1 0:1 0:1 0:1 0:1 0:1 0:1 0:1 0:1 0:1 0:1 0:1 0:1 0:1 0:1 
13:2 13:2 13:2 13:2 13:2 13:2 13:2 13:2 13:2 13:2 13:2 13:2 13:2 13:2 13:2 13:2 13:2 13:2 13:2 13:2 13:2 13:2 13:2 0:1 0:1 0:1 0:1 0:1 0:1 0:1 0:1 0:1 0:1 0:1 0:1 0:1 0:1 0:1 0:1 0:1 13:2 13:2 13:2 13:2 13:2 13:2 13:2 13:2 13:2 13:2 13:2 13:2 13:2 13:2 13:2 13:2 13:2 13:2 13:2 13:2 13:2 13:2 13:2 0:1 0:1 0:1 0:1 0:1 0:1 0:1 0:1 0:1 0:1 0:1 0:1 0:1 0:1 0:1 0:1 0:1 
13:2 13:2 13:2 13:2 13:2 13:2 13:2 13:2 13:2 13:2 13:2 13:2 13:2 13:2 13:2 13:2 13:2 13:2 13:2 13:2 13:2 13:2 13:2 13:2 0:1 0:1 0:1 0:1 0:1 0:1 0:1 0:1 0:1 0:1 0:1 0:1 0:1 0:1 0:1 0:1 13:2 13:2 13:2 13:2 13:2 13:2 13:2 13:2 13:2 13:2 13:2 13:2 13:2 13:2 13:2 13:2 13:2 13:2 13:2 13:2 13:2 13:2 13:2 0:1 0:1 0:1 0:1 0:1 0:1 0:1 0:1 0:1 0:1 0:1 0:1 0:1 0:1 0:1 0:1 0:1 
13:2 13:2 13:2 13:2 13:2 13:2 13:2 13:2 13:2 13:2 13:2 13:2 13:2 13:2 13:2 13:2 13:2 13:2 13:2 13:2 13:2 13:2 13:2 13:2 13:2 0:1 0:1 0:1 0:1 0:1 0:1 0:1 0:1 0:1 0:1 0:1 0:1 0:1 0:1 0:1 13:2 13:2 13:2 13:2 13:2 13:2 13:2 13:2 13:2 13:2 13:2 13:2 13:2 13:2 13:2 13:2 13:2 13:2 13:2 13:2 13:2 13:2 13:2 0:1 0:1 0:1 0:1 0:1 0:1 0:1 0:1 0:1 0:1 0:1 0:1 0:1 0:1 0:1 0:1 0:1 
13:2 13:2 13:2 13:2 13:2 13:2 13:2 13:2 13:2 13:2 13:2 13:2 13:2 13:2 13:2 13:2 13:2 13:2 13:2 13:2 13:2 13:2 13:2 13:2 13:2 13:2 0:1 0:1 0:1 0:1 0:1 0:1 0:1 0:1 0:1 0:1 0:1 0:1 0:1 0:1 13:2 13:2 13:2 13:2 13:2 13:2 13:2 13:2 13:2 13:2 13:2 13:2 13:2 13:2 13:2 13:2 13:2 13:2 13:2 13:2 13:2 13:2 13:2 0:1 0:1 0:1 0:1 0:1 0:1 0:1 0:1 0:1 0:1 0:1 0:1 0:1 0:1 0:1 0:1 0:1 
13:2 13:2 13:2 13:2 13:2 13:2 13:2 13:2 13:2 13:2 13:2 13:2 13:2 13:2 13:2 13:2 13:2 13:2 13:2 13:2 13:2 13:2 13:2 13:2 13:2 13:2 13:2 0:1 0:1 0:1 0:1 0:1 0:1 0:1 0:1 0:1 0:1 0:1 0:1 0:1 13:2 13:2 13:2 13:2 13:2 13:2 13:2 13:2 13:2 13:2 13:2 13:2 13:2 13:2 13:2 13:2 13:2 13:2 13:2 13:2 13:2 13:2 13:2 0:1 0:1 0:1 0:1 0:1 0:1 0:1 0:1 0:1 0:1 0:1 0:1 0:1 0:1 0:1 0:1 0:1 
13:2 13:2 13:2 13:2 13:2 13:2 13:2 13:2 13:2 13:2 13:2 13:2 13:2 13:2 13:2 13:2 13:2 13:2 13:2 13:2 13:2 13:2 13:2 13:2 13:2 13:2 13:2 13:2 0:1 0:1 0:1 0:1 0:1 0:1 0:1 0:1 0:1 0:1 0:1 0:1 13:2 13:2 13:2 13:2 13:2 13:2 13:2 13:2 13:2 13:2 13:2 13:2 13:2 13:2 13:2 13:2 13:2 13:2 13:2 13:2 13:2 13:2 13:2 0:1 0:1 0:1 0:1 0:1 0:1 0:1 0:1 0:1 0:1 0:1 0:1 0:1 0:1 0:1 0:1 0:1 
13:2 13:2 13:2 13:2 13:2 13:2 13:2 13:2 13:2 13:2 13:2 13:2 13:2 13:2 13:2 13:2 13:2 13:2 13:2 13:2 13:2 13:2 13:2 13:2 13:2 13:2 13:2 13:2 13:2 0:1 0:1 0:1 0:1 0:1 0:1 0:1 0:1 0:1 0:1 0:1 13:2 13:2 13:2 13:2 13:2 13:2 13:2 13:2 13:2 13:2 13:2 13:2 13:2 13:2 13:2 13:2 13:2 13:2 13:2 13:2 13:2 13:2 13:2 0:1 0:1 0:1 0:1 0:1 0:1 0:1 0:1 0:1 0:1 0:1 0:1 0:1 0:1 0:1 0:1 0:1 
13:2 13:2 13:2 13:2 13:2 13:2 13:2 13:2 13:2 13:2 13:2 13:2 13:2 13:2 13:2 13:2 13:2 13:2 13:2 13:2 13:2 13:2 13:2 13:2 13:2 13:2 13:2 13:2 13:2 13:2 0:1 0:1 0:1 0:1 0:1 0:1 0:1 0:1 0:1 0:1 13:2 13:2 13:2 13:2 13:2 13:2 13:2 13:2 13:2 13:2 13:2 13:2 13:2 13:2 13:2 13:2 13:2 13:2 13:2 13:2 13:2 13:2 13:2 0:1 0:1 0:1 0:1 0:1 0:1 0:1 0:1 0:1 0:1 0:1 0:1 0:1 0:1 0:1 0:1 0:1 
13:2 13:2 13:2 13:2 13:2 13:2 13:2 13:2 13:2 13:2 13:2 13:2 13:2 13:2 13:2 13:2 13:2 13:2 13:2 13:2 13:2 13:2 13:2 13:2 13:2 13:2 13:2 13:2 13:2 13:2 13:2 0:1 0:1 0:1 0:1 0:1 0:1 0:1 0:1 0:1 13:2 13:2 13:2 13:2 13:2 13:2 13:2 13:2 13:2 13:2 13:2 13:2 13:2 13:2 13:2 13:2 13:2 13:2 13:2 13:2 13:2 13:2 13:2 0:1 0:1 0:1 0:1 0:1 0:1 0:1 0:1 0:1 0:1 0:1 0:1 0:1 0:1 0:1 0:1 0:1 
13:2 13:2 13:2 13:2 13:2 13:2 13:2 13:2 13:2 13:2 13:2 13:2 13:2 13:2 13:2 13:2 13:2 13:2 13:2 13:2 13:2 13:2 13:2 13:2 13:2 13:2 13:2 13:2 13:2 13:2 13:2 13:2 0:1 0:1 0:1 0:1 0:1 0:1 0:1 0:1 13:2 13:2 13:2 13:2 13:2 13:2 13:2 13:2 13:2 13:2 13:2 13:2 13:2 13:2 13:2 13:2 13:2 13:2 13:2 13:2 13:2 13:2 13:2 0:1 0:1 0:1 0:1 0:1 0:1 0:1 0:1 0:1 0:1 0:1 0:1 0:1 0:1 0:1 0:1 0:1
13:1 13:1 13:1 13:1 13:1 13:1 13:1 13:1 13:1 13:1 13:1 13:1 13:1 13:1 13:1 13:1 13:1 13:1 13:1 13:1 13:1 13:1 13:1 13:2 13:2 13:2 13:2 13:2 13:2 13:2 13:2 13:2 0:1 0:1 0:1 0:1 0:1 0:1 0:1 0:1 13:2 13:2 13:2 13:2 13:2 0:1 0:1 0:1 0:1 0:1 0:1 0:1 0:1 0:1 0:1 0:1 0:1 18:1 19:1 20:1 21:1 22:1 0:1 0:1 0:1 0:1 0:1 0:1 0:1 0:1 0:1 0:1 0:1 0:1 0:1 0:1 0:1 0:1 0:1 0:1
13:1 13:1 13:1 13:1 13:1 13:1 13:1 13:1 13:1 13:1 13:1 13:1 13:1 13:1 13:1 13:1 13:1 13:1 13:1 13:1 13:1 13:1 13:1 13:2 13:2 13:2 13:2 13:2 13:2 13:2 13:2 13:2 0:1 0:1 0:1 0:1 0:1 0:1 0:1 0:1 13:2 13:2 13:2 13:2 13:2 0:1 0:1 0:1 0:1 0:1 0:1 0:1 0:1 0:1 0:1 0:1 0:1 0:1 0:1 0:1 0:1 0:1 0:1 0:1 0:1 0:1 0:1 0:1 0:1 0:1 0:1 0:1 0:1 0:1 0:1 0:1 0:1 0:1 0:1 0:1
13:1 13:1 13:1 13:1 13:1 13:1 13:1 13:1 13:1 13:1 13:1 13:1 13:1 13:1 13:1 13:1 13:1 13:1 13:1 13:1 13:1 13:1 13:1 13:2 13:2 13:2 13:2 13:2 13:2 13:2 13:2 13:2 0:1 0:1 0:1 0:1 0:1 0:1 0:1 0:1 13:2 13:2 13:2 13:2 13:2 0:1 0:1 0:1 0:1 0:1 0:1 0:1 0:1 0:1 0:1 0:1 0:1 0:1 0:1 0:1 0:1 0:1 0:1 0:1 0:1 0:1 0:1 0:1 0:1 0:1 0:1 0:1 0:1 0:1 0:1 0:1 0:1 0:1 0:1 0:1
13:1 13:1 13:1 13:1 13:1 13:1 13:1 13:1 13:1 13:1 13:1 13:1 13:1 13:1 13:1 13:1 13:1 13:1 13:1 13:1 13:1 13:1 13:1 13:2 13:2 13:2 13:2 13:2 13:2 13:2 13:2 13:2 0:1 0:1 0:1 0:1 0:1 0:1 0:1 0:1 13:2 13:2 13:2 13:2 13:2 0:1 0:1 0:1 0:1 0:1 0:1 0:1 0:1 0:1 0:1 0:1 0:1 0:1 0:1 0:1 0:1 0:1 0:1 0:1 0:1 0:1 0:1 0:1 0:1 0:1 0:1 0:1 0:1 0:1 0:1 0:1 0:1 0:1 0:1 0:1
13:1 13:1 13:1 13:1 13:1 13:1 13:1 13:1 13:1 13:1 13:1 13:1 13:1 13:1 13:1 13:1 13:1 13:1 13:1 13:1 13:1 13:1 13:1 13:2 13:2 13:2 13:2 13:2 13:2 13:2 13:2 13:2 0:1 0:1 0:1 0:1 0:1 0:1 0:1 0:1 13:2 13:2 13:2 13:2 13:2 0:1 0:1 0:1 0:1 0:1 0:1 0:1 0:1 0:1 0:1 0:1 0:1 0:1 0:1 0:1 0:1 0:1 0:1 0:1 0:1 0:1 0:1 0:1 0:1 0:1 0:1 0:1 0:1 0:1 0:1 0:1 0:1 0:1 0:1 0:1
13:1 13:1 13:1 13:1 13:1 13:1 13:1 13:1 13:1 13:1 13:1 13:1 13:1 13:1 13:1 13:1 13:1 13:1 13:1 13:1 13:1 13:1 13:1 13:2 13:2 13:2 13:2 13:2 13:2 13:2 13:2 13:2 13:2 0:1 0:1 0:1 0:1 0:1 0:1 0:1 13:2 13:2 13:2 13:2 13:2 0:1 0:1 0:1 0:1 0:1 0:1 0:1 0:1 0:1 0:1 0:1 0:1 0:1 0:1 0:1 0:1 0:1 0:1 0:1 0:1 0:1 0:1 0:1 0:1 0:1 0:1 0:1 0:1 0:1 0:1 0:1 0:1 0:1 0:1 0:1
13:1 13:1 13:1 13:1 13:1 13:1 13:1 13:1 13:1 13:1 13:1 13:1 13:1 13:1 13:1 13:1 13:1 13:1 13:1 13:1 13:1 13:1 13:1 13:2 13:2 13:2 13:2 13:2 13:2 13:2 13:2 13:2 13:2 0:1 0:1 0:1 0:1 0:1 0:1 0:1 0:1 0:1 0:1 0:1 0:1 0:1 0:1 0:1 0:1 0:1 0:1 0:1 0:1 0:1 0:1 0:1 0:1 0:1 0:1 0:1 0:1 0:1 0:1 0:1 0:1 0:1 0:1 0:1 0:1 0:1 0:1 0:1 0:1 0:1 0:1 0:1 0:1 0:1 0:1 0:1
13:1 13:1 13:1 13:1 13:1 13:1 13:1 13:1 13:1 13:1 13:1 13:1 13:1 13:1 13:1 13:1 13:1 13:1 13:1 13:1 13:1 13:1 13:1 13:2 13:2 13:2 13:2 13:2 13:2 13:2 13:2 13:2 13:2 0:1 0:1 0:1 0:1 0:1 0:1 0:1 0:1 0:1 0:1 0:1 0:1 0:1 0:1 0:1 0:1 0:1 0:1 0:1 0:1 0:1 0:1 0:1 0:1 0:1 0:1 0:1 0:1 0:1 0:1 0:1 0:1 0:1 0:1 0:1 0:1 0:1 0:1 0:1 0:1 0:1 0:1 0:1 0:1 0:1 0:1 0:1
13:1 13:1 13:1 13:1 13:1 13:1 13:1 13:1 13:1 13:1 13:1 13:1 13:1 13:1 13:1 13:1 13:1 13:1 13:1 13:1 13:1 13:1 13:1 13:2 13:2 13:2 13:2 13:2 13:2 13:2 13:2 13:2 13:2 0:1 0:1 0:1 0:1 0:1 0:1 0:1 0:1 0:1 0:1 0:1 0:1 0:1 0:1 0:1 0:1 0:1 0:1 0:1 0:1 0:1 0:1 0:1 0:1 0:1 0:1 0:1 0:1 0:1 0:1 0:1 0:1 0:1 0:1 0:1 0:1 0:1 0:1 0:1 0:1 0:1 0:1 0:1 0:1 0:1 0:1 0:1
13:1 13:1 13:1 13:1 13:1 13:1 13:1 13:1 13:1 13:1 13:1 13:1 13:1 13:1 13:1 13:1 13:1 13:1 13:1 13:1 13:1 13:1 13:1 13:2 13:2 13:2 13:2 13:2 13:2 13:2 13:2 13:2 13:2 0:1 0:1 0:1 0:1 0:1 0:1 0:1 0:1 0:1 0:1 0:1 0:1 0:1 0:1 0:1 0:1 0:1 0:1 0:1 0:1 0:1 0:1 0:1 0:1 0:1 0:1 0:1 0:1 0:1 0:1 0:1 0:1 0:1 0:1 0:1 0:1 0:1 0:1 0:1 0:1 0:1 0:1 0:1 0:1 0:1 0:1 0:1
13:1 13:1 13:1 13:1 13:1 13:1 13:1 13:1 13:1 13:1 13:1 13:1 13:1 13:1 13:1 13:1 13:1 13:1 13:1 13:1 13:1 13:1 13:1 13:2 13:2 13:2 13:2 13:2 13:2 13:2 13:2 13:2 13:2 0:1 0:1 0:1 0:1 0:1 0:1 0:1 0:1 0:1 0:1 0:1 0:1 0:1 0:1 0:1 0:1 0:1 0:1 0:1 0:1 0:1 0:1 0:1 0:1 0:1 0:1 0:1 0:1 0:1 0:1 0:1 0:1 0:1 0:1 0:1 0:1 0:1 0:1 0:1 0:1 0:1 0:1 0:1 0:1 0:1 0:1 0:1
13:1 13:1 13:1 13:1 13:1 13:1 13:1 13:1 13:1 13:1 13:1 13:1 13:1 13:1 13:1 13:1 13:1 13:1 13:1 13:1 13:1 13:1 13:1 13:2 13:2 13:2 13:2 13:2 13:2 13:2 13:2 13:2 13:2 0:1 0:1 0:1 0:1 0:1 0:1 0:1 0:1 0:1 0:1 0:1 0:1 0:1 0:1 0:1 0:1 0:1 0:1 0:1 0:1 0:1 0:1 0:1 0:1 0:1 0:1 0:1 0:1 0:1 0:1 0:1 0:1 0:1 0:1 0:1 0:1 0:1 0:1 0:1 0:1 0:1 0:1 0:1 0:1 0:1 0:1 0:1